date,location,positive,negative,neutral,total,perception
2019-11-24,Arizona,7,1,4,12,0.75
2019-11-24,Idaho,2,0,1,3,0.8333333333333333
2019-11-24,North Carolina,1,1,2,4,0.5
2019-11-24,Florida,15,5,8,28,0.6785714285714286
2019-11-24,Arkansas,10,11,10,31,0.4838709677419355
2019-11-24,Indiana,9,5,12,26,0.5769230769230769
2019-11-24,Washington,2,0,0,2,1.0
2019-11-24,Alabama,19,16,16,51,0.5294117647058824
2019-11-24,California,21,6,13,40,0.6875
2019-11-24,Nebraska,11,6,7,24,0.6041666666666666
2019-11-24,Texas,6,5,2,13,0.5384615384615385
2019-11-24,Massachusetts,4,3,2,9,0.5555555555555556
2019-11-24,Connecticut,2,2,0,4,0.5
2019-11-24,Pennsylvania,4,1,2,7,0.7142857142857142
2019-11-24,Delaware,2,2,4,8,0.5
2019-11-24,Iowa,7,1,1,9,0.8333333333333334
2019-11-24,Colorado,13,5,6,24,0.6666666666666666
2019-11-24,Hawaii,12,5,8,25,0.64
2019-11-24,Georgia,8,3,6,17,0.6470588235294118
2019-11-24,Louisiana,3,4,3,10,0.44999999999999996
2019-11-24,Illinois,8,3,3,14,0.6785714285714285
2019-11-24,Michigan,0,1,3,4,0.375
2019-11-24,Mississippi,1,0,1,2,0.75
2019-11-24,Oregon,2,1,4,7,0.5714285714285714
2019-11-24,Kansas,4,0,0,4,1.0
2019-11-24,Kentucky,2,0,0,2,1.0
2019-11-24,New York,6,1,2,9,0.7777777777777777
2019-11-24,Wisconsin,2,0,0,2,1.0
2019-11-24,Maryland,1,0,0,1,1.0
2019-11-24,Alaska,2,0,3,5,0.7
2019-11-24,Utah,0,0,1,1,0.5
2019-11-24,Missouri,1,0,1,2,0.75
2019-11-24,West Virginia,0,1,0,1,0.0
2019-11-24,New Jersey,0,0,1,1,0.5
2019-11-24,North Dakota,1,0,0,1,1.0
2019-11-24,South Carolina,0,1,0,1,0.0
2019-11-24,Maine,0,0,1,1,0.5
2019-11-23,Alabama,94,89,125,308,0.5081168831168831
2019-11-23,Nevada,0,0,3,3,0.5
2019-11-23,Texas,21,39,51,111,0.41891891891891897
2019-11-23,Indiana,31,53,52,136,0.4191176470588235
2019-11-23,Illinois,24,32,28,84,0.45238095238095233
2019-11-23,Delaware,13,15,19,47,0.4787234042553191
2019-11-23,Louisiana,15,23,52,90,0.4555555555555555
2019-11-23,Pennsylvania,7,7,12,26,0.5
2019-11-23,Hawaii,44,39,53,136,0.5183823529411765
2019-11-23,California,58,53,77,188,0.5132978723404256
2019-11-23,Florida,41,27,45,113,0.5619469026548672
2019-11-23,Georgia,23,36,39,98,0.4336734693877551
2019-11-23,Colorado,30,36,45,111,0.472972972972973
2019-11-23,Arkansas,41,43,65,149,0.49328859060402686
2019-11-23,Massachusetts,18,19,19,56,0.4910714285714286
2019-11-23,North Carolina,2,4,4,10,0.4
2019-11-23,Virginia,2,1,1,4,0.625
2019-11-23,Arizona,10,8,19,37,0.527027027027027
2019-11-23,Washington,10,10,13,33,0.5
2019-11-23,Oregon,9,5,11,25,0.58
2019-11-23,Nebraska,32,28,40,100,0.52
2019-11-23,New York,9,12,25,46,0.46739130434782605
2019-11-23,Iowa,11,18,9,38,0.40789473684210525
2019-11-23,Wisconsin,1,3,1,5,0.30000000000000004
2019-11-23,Connecticut,9,4,2,15,0.6666666666666666
2019-11-23,South Carolina,0,2,1,3,0.16666666666666666
2019-11-23,Kansas,3,9,12,24,0.375
2019-11-23,Michigan,5,4,7,16,0.53125
2019-11-23,Alaska,9,9,10,28,0.5
2019-11-23,Missouri,9,3,7,19,0.6578947368421052
2019-11-23,New Jersey,10,5,5,20,0.625
2019-11-23,Idaho,4,2,4,10,0.6000000000000001
2019-11-23,Utah,3,4,3,10,0.44999999999999996
2019-11-23,Maryland,1,0,1,2,0.75
2019-11-23,Maine,1,1,3,5,0.5
2019-11-23,Ohio,3,4,3,10,0.44999999999999996
2019-11-23,Minnesota,1,2,5,8,0.4375
2019-11-23,West Virginia,0,0,1,1,0.5
2019-11-23,Mississippi,0,4,3,7,0.21428571428571427
2019-11-23,Kentucky,2,3,5,10,0.45
2019-11-23,New Hampshire,0,1,2,3,0.3333333333333333
2019-11-23,Oklahoma,1,1,2,4,0.5
2019-11-23,Montana,0,1,1,2,0.25
2019-11-23,Rhode Island,0,1,0,1,0.0
2019-11-23,New Mexico,0,0,1,1,0.5
2019-11-23,North Dakota,0,0,1,1,0.5
2019-11-22,Arizona,81,48,123,252,0.5654761904761905
2019-11-22,Pennsylvania,28,15,47,90,0.5722222222222222
2019-11-22,Alaska,51,31,64,146,0.5684931506849316
2019-11-22,Georgia,164,71,258,493,0.5943204868154158
2019-11-22,California,307,220,622,1149,0.5378590078328982
2019-11-22,Nebraska,314,98,323,735,0.6469387755102041
2019-11-22,Hawaii,274,79,249,602,0.6619601328903655
2019-11-22,Indiana,204,97,267,568,0.5941901408450705
2019-11-22,Oregon,53,20,75,148,0.6114864864864865
2019-11-22,Alabama,370,241,648,1259,0.5512311358220809
2019-11-22,Arkansas,192,124,381,697,0.5487804878048781
2019-11-22,Illinois,89,48,150,287,0.5714285714285714
2019-11-22,Connecticut,17,6,29,52,0.6057692307692308
2019-11-22,Florida,106,84,239,429,0.5256410256410257
2019-11-22,Colorado,189,109,242,540,0.5740740740740741
2019-11-22,Missouri,40,30,65,135,0.537037037037037
2019-11-22,Iowa,52,22,87,161,0.5931677018633541
2019-11-22,Texas,80,66,305,451,0.5155210643015521
2019-11-22,Delaware,89,24,124,237,0.6371308016877637
2019-11-22,Louisiana,73,61,155,289,0.5207612456747405
2019-11-22,New York,74,35,140,249,0.5783132530120482
2019-11-22,Kansas,24,20,35,79,0.5253164556962026
2019-11-22,Massachusetts,134,39,122,295,0.6610169491525424
2019-11-22,New Jersey,24,6,38,68,0.6323529411764706
2019-11-22,Michigan,20,15,58,93,0.5268817204301075
2019-11-22,North Carolina,21,7,26,54,0.6296296296296297
2019-11-22,Mississippi,5,4,6,15,0.5333333333333333
2019-11-22,Washington,59,19,70,148,0.6351351351351351
2019-11-22,Idaho,20,7,22,49,0.6326530612244898
2019-11-22,New Mexico,6,0,3,9,0.8333333333333333
2019-11-22,Oklahoma,6,4,12,22,0.5454545454545454
2019-11-22,South Carolina,2,3,7,12,0.45833333333333337
2019-11-22,Maine,10,6,15,31,0.564516129032258
2019-11-22,Virginia,6,4,17,27,0.537037037037037
2019-11-22,Maryland,7,2,20,29,0.5862068965517242
2019-11-22,Kentucky,7,6,22,35,0.5142857142857142
2019-11-22,Minnesota,11,6,6,23,0.6086956521739131
2019-11-22,Utah,6,2,11,19,0.6052631578947368
2019-11-22,Tennessee,4,1,7,12,0.625
2019-11-22,Ohio,12,8,19,39,0.5512820512820513
2019-11-22,Rhode Island,4,2,6,12,0.5833333333333333
2019-11-22,Montana,1,1,5,7,0.5
2019-11-22,Nevada,15,5,3,23,0.717391304347826
2019-11-22,Wisconsin,12,2,6,20,0.75
2019-11-22,North Dakota,17,3,11,31,0.7258064516129032
2019-11-22,South Dakota,0,0,2,2,0.5
2019-11-22,West Virginia,0,0,3,3,0.5
2019-11-22,Wyoming,0,1,1,2,0.25
2019-11-22,New Hampshire,3,1,0,4,0.75
2019-11-22,Vermont,3,0,0,3,1.0
2019-11-21,California,52,19,52,123,0.6341463414634146
2019-11-21,Alaska,3,3,13,19,0.5
2019-11-21,Kansas,0,1,4,5,0.4
2019-11-21,Iowa,8,4,11,23,0.5869565217391304
2019-11-21,Hawaii,37,10,22,69,0.6956521739130435
2019-11-21,Alabama,33,10,56,99,0.6161616161616161
2019-11-21,Colorado,18,5,25,48,0.6354166666666667
2019-11-21,North Dakota,0,0,1,1,0.5
2019-11-21,Kentucky,1,1,1,3,0.5
2019-11-21,Texas,10,2,25,37,0.6081081081081081
2019-11-21,Pennsylvania,3,1,7,11,0.5909090909090908
2019-11-21,New York,13,6,23,42,0.5833333333333334
2019-11-21,Nebraska,20,6,24,50,0.64
2019-11-21,Delaware,18,3,9,30,0.75
2019-11-21,Arizona,7,9,16,32,0.46875
2019-11-21,Massachusetts,21,3,15,39,0.7307692307692307
2019-11-21,New Mexico,1,0,0,1,1.0
2019-11-21,Arkansas,21,9,34,64,0.59375
2019-11-21,Washington,11,1,6,18,0.7777777777777778
2019-11-21,Georgia,3,11,24,38,0.39473684210526316
2019-11-21,Indiana,15,7,34,56,0.5714285714285714
2019-11-21,Oklahoma,1,0,1,2,0.75
2019-11-21,Illinois,13,4,14,31,0.6451612903225806
2019-11-21,Florida,17,9,23,49,0.5816326530612245
2019-11-21,Rhode Island,0,1,1,2,0.25
2019-11-21,Ohio,0,0,3,3,0.5
2019-11-21,Montana,1,1,0,2,0.5
2019-11-21,New Jersey,2,2,6,10,0.5
2019-11-21,Missouri,6,6,13,25,0.5
2019-11-21,Maryland,1,1,2,4,0.5
2019-11-21,Michigan,3,1,1,5,0.7
2019-11-21,Connecticut,3,0,6,9,0.6666666666666666
2019-11-21,Louisiana,7,4,12,23,0.5652173913043479
2019-11-21,Oregon,4,0,6,10,0.7
2019-11-21,Nevada,1,0,2,3,0.6666666666666666
2019-11-21,Virginia,0,1,1,2,0.25
2019-11-21,Minnesota,1,0,2,3,0.6666666666666666
2019-11-21,Mississippi,0,0,1,1,0.5
2019-11-21,Utah,0,0,1,1,0.5
2019-11-21,Tennessee,1,0,2,3,0.6666666666666666
2019-11-21,North Carolina,1,0,4,5,0.6000000000000001
2019-11-21,Maine,0,0,4,4,0.5
2019-11-21,Wisconsin,1,0,0,1,1.0
2019-11-21,Idaho,0,1,1,2,0.25
2019-11-21,South Carolina,0,1,0,1,0.0
2019-11-20,Massachusetts,70,26,40,136,0.6617647058823529
2019-11-20,Connecticut,13,5,5,23,0.6739130434782609
2019-11-20,Alaska,24,8,11,43,0.686046511627907
2019-11-20,California,132,50,108,290,0.6413793103448276
2019-11-20,Iowa,33,15,8,56,0.6607142857142857
2019-11-20,Minnesota,7,1,4,12,0.75
2019-11-20,Colorado,82,28,56,166,0.6626506024096386
2019-11-20,Arkansas,122,39,58,219,0.6894977168949772
2019-11-20,Florida,85,32,16,133,0.6992481203007519
2019-11-20,Georgia,55,27,43,125,0.612
2019-11-20,Alabama,239,68,98,405,0.7111111111111111
2019-11-20,Missouri,11,6,22,39,0.5641025641025641
2019-11-20,New York,41,14,32,87,0.6551724137931034
2019-11-20,Hawaii,117,33,65,215,0.6953488372093024
2019-11-20,Indiana,104,25,56,185,0.7135135135135136
2019-11-20,Nebraska,177,28,54,259,0.7876447876447876
2019-11-20,New Jersey,4,7,5,16,0.40625
2019-11-20,Maryland,7,5,6,18,0.5555555555555556
2019-11-20,Washington,23,7,13,43,0.6860465116279069
2019-11-20,Arizona,36,11,18,65,0.6923076923076923
2019-11-20,Michigan,6,3,7,16,0.59375
2019-11-20,Texas,66,28,33,127,0.6496062992125984
2019-11-20,Pennsylvania,17,5,6,28,0.7142857142857142
2019-11-20,Maine,5,1,5,11,0.6818181818181818
2019-11-20,Louisiana,58,17,26,101,0.7029702970297029
2019-11-20,North Dakota,6,0,1,7,0.9285714285714285
2019-11-20,Oregon,21,4,5,30,0.7833333333333333
2019-11-20,New Hampshire,2,1,1,4,0.625
2019-11-20,Delaware,32,11,19,62,0.6693548387096774
2019-11-20,Illinois,47,9,28,84,0.7261904761904762
2019-11-20,Mississippi,3,1,2,6,0.6666666666666666
2019-11-20,Virginia,4,6,4,14,0.42857142857142855
2019-11-20,Nevada,1,0,2,3,0.6666666666666666
2019-11-20,Utah,4,4,5,13,0.5
2019-11-20,Kansas,11,2,4,17,0.7647058823529412
2019-11-20,North Carolina,9,3,5,17,0.6764705882352942
2019-11-20,Montana,2,1,0,3,0.6666666666666666
2019-11-20,Rhode Island,2,1,3,6,0.5833333333333333
2019-11-20,Idaho,11,3,6,20,0.7000000000000001
2019-11-20,Ohio,3,2,1,6,0.5833333333333334
2019-11-20,South Carolina,4,0,0,4,1.0
2019-11-20,Oklahoma,4,2,3,9,0.611111111111111
2019-11-20,New Mexico,1,0,1,2,0.75
2019-11-20,Kentucky,12,1,4,17,0.823529411764706
2019-11-20,South Dakota,1,1,1,3,0.5
2019-11-20,Wisconsin,4,0,0,4,1.0
2019-11-19,Georgia,2,2,4,8,0.5
2019-11-19,Illinois,2,3,6,11,0.45454545454545453
2019-11-19,California,20,7,19,46,0.6413043478260869
2019-11-19,Indiana,6,6,9,21,0.5
2019-11-19,Alabama,16,3,14,33,0.696969696969697
2019-11-19,Arkansas,10,4,14,28,0.6071428571428572
2019-11-19,Louisiana,6,3,3,12,0.625
2019-11-19,Massachusetts,9,3,9,21,0.6428571428571428
2019-11-19,Delaware,9,2,3,14,0.75
2019-11-19,Iowa,2,2,1,5,0.5
2019-11-19,Kansas,3,1,0,4,0.75
2019-11-19,Hawaii,11,0,3,14,0.8928571428571428
2019-11-19,New York,5,1,6,12,0.6666666666666667
2019-11-19,Florida,5,7,9,21,0.45238095238095233
2019-11-19,Colorado,5,2,4,11,0.6363636363636364
2019-11-19,Maryland,0,0,4,4,0.5
2019-11-19,Minnesota,2,0,1,3,0.8333333333333333
2019-11-19,Washington,2,2,2,6,0.5
2019-11-19,Missouri,6,2,10,18,0.6111111111111112
2019-11-19,Connecticut,0,1,1,2,0.25
2019-11-19,North Dakota,0,3,0,3,0.0
2019-11-19,New Jersey,2,1,0,3,0.6666666666666666
2019-11-19,Virginia,1,0,1,2,0.75
2019-11-19,Oregon,1,0,0,1,1.0
2019-11-19,Nebraska,1,0,1,2,0.75
2019-11-19,South Carolina,1,0,0,1,1.0
2019-11-19,Michigan,1,0,0,1,1.0
2019-11-19,Texas,0,2,3,5,0.3
2019-11-19,Arizona,1,4,1,6,0.25
2019-11-19,New Hampshire,0,0,1,1,0.5
2019-11-19,Alaska,0,0,6,6,0.5
2019-11-19,North Carolina,2,0,0,2,1.0
2019-11-19,Maine,0,1,0,1,0.0
2019-11-19,Nevada,0,1,0,1,0.0
2019-11-19,Ohio,2,0,1,3,0.8333333333333333
2019-11-19,Pennsylvania,0,1,0,1,0.0
2019-11-18,Florida,5,3,6,14,0.5714285714285714
2019-11-18,Arkansas,13,5,10,28,0.6428571428571429
2019-11-18,California,25,27,27,79,0.4873417721518988
2019-11-18,Alabama,17,9,13,39,0.6025641025641025
2019-11-18,Colorado,7,3,3,13,0.6538461538461539
2019-11-18,Georgia,6,2,6,14,0.6428571428571428
2019-11-18,Idaho,1,0,3,4,0.625
2019-11-18,Missouri,2,0,1,3,0.8333333333333333
2019-11-18,Massachusetts,6,3,4,13,0.6153846153846154
2019-11-18,Utah,0,0,1,1,0.5
2019-11-18,Hawaii,6,1,3,10,0.75
2019-11-18,New York,3,0,3,6,0.75
2019-11-18,Mississippi,0,0,1,1,0.5
2019-11-18,South Carolina,0,1,0,1,0.0
2019-11-18,Indiana,2,3,2,7,0.42857142857142855
2019-11-18,Louisiana,7,2,2,11,0.7272727272727273
2019-11-18,Alaska,2,2,4,8,0.5
2019-11-18,Nebraska,1,2,4,7,0.42857142857142855
2019-11-18,Arizona,4,2,1,7,0.6428571428571428
2019-11-18,Illinois,3,0,3,6,0.75
2019-11-18,Texas,2,0,5,7,0.6428571428571428
2019-11-18,Iowa,5,0,0,5,1.0
2019-11-18,Maine,0,2,0,2,0.0
2019-11-18,Virginia,0,2,1,3,0.16666666666666666
2019-11-18,Maryland,4,0,0,4,1.0
2019-11-18,Oregon,1,0,0,1,1.0
2019-11-18,Kentucky,3,0,1,4,0.875
2019-11-18,Delaware,4,0,1,5,0.9
2019-11-18,New Jersey,1,1,2,4,0.5
2019-11-18,Kansas,0,0,1,1,0.5
2019-11-18,Connecticut,0,0,1,1,0.5
2019-11-18,Oklahoma,1,0,0,1,1.0
2019-11-18,Ohio,0,1,0,1,0.0
2019-11-18,Michigan,0,1,0,1,0.0
2019-11-18,Pennsylvania,1,0,0,1,1.0
2019-11-17,California,63,14,42,119,0.7058823529411765
2019-11-17,Arkansas,26,17,32,75,0.56
2019-11-17,Massachusetts,13,3,9,25,0.7
2019-11-17,Alabama,70,21,38,129,0.689922480620155
2019-11-17,Florida,25,15,13,53,0.5943396226415094
2019-11-17,Michigan,8,2,6,16,0.6875
2019-11-17,Indiana,34,8,13,55,0.7363636363636363
2019-11-17,Nebraska,40,8,18,66,0.7424242424242424
2019-11-17,Iowa,10,4,6,20,0.65
2019-11-17,Utah,3,1,2,6,0.6666666666666666
2019-11-17,Georgia,16,10,15,41,0.5731707317073171
2019-11-17,Washington,9,1,4,14,0.7857142857142858
2019-11-17,Colorado,28,10,20,58,0.6551724137931034
2019-11-17,Illinois,15,4,7,26,0.7115384615384615
2019-11-17,Louisiana,18,5,12,35,0.6857142857142857
2019-11-17,New Jersey,4,2,0,6,0.6666666666666666
2019-11-17,Pennsylvania,4,0,4,8,0.75
2019-11-17,Delaware,11,5,8,24,0.625
2019-11-17,Hawaii,23,10,8,41,0.6585365853658537
2019-11-17,Idaho,8,4,0,12,0.6666666666666666
2019-11-17,Connecticut,1,2,1,4,0.375
2019-11-17,Oklahoma,1,0,1,2,0.75
2019-11-17,New York,11,2,7,20,0.7250000000000001
2019-11-17,Wisconsin,2,1,0,3,0.6666666666666666
2019-11-17,Alaska,8,6,8,22,0.5454545454545454
2019-11-17,Tennessee,0,1,0,1,0.0
2019-11-17,Arizona,5,6,6,17,0.47058823529411764
2019-11-17,Maine,3,1,0,4,0.75
2019-11-17,Texas,9,5,15,29,0.5689655172413793
2019-11-17,Kentucky,4,0,1,5,0.9
2019-11-17,Nevada,1,1,2,4,0.5
2019-11-17,Missouri,12,5,10,27,0.6296296296296295
2019-11-17,Oregon,4,1,3,8,0.6875
2019-11-17,Minnesota,2,0,2,4,0.75
2019-11-17,Kansas,4,0,1,5,0.9
2019-11-17,Ohio,4,0,2,6,0.8333333333333333
2019-11-17,North Carolina,2,0,0,2,1.0
2019-11-17,South Carolina,1,0,1,2,0.75
2019-11-17,North Dakota,2,2,0,4,0.5
2019-11-17,Rhode Island,1,0,0,1,1.0
2019-11-17,New Hampshire,0,0,1,1,0.5
2019-11-17,Maryland,1,0,0,1,1.0
2019-11-16,Oregon,41,9,22,72,0.7222222222222222
2019-11-16,Indiana,191,35,69,295,0.764406779661017
2019-11-16,Alaska,39,21,12,72,0.625
2019-11-16,Texas,79,21,31,131,0.7213740458015268
2019-11-16,New Jersey,22,4,12,38,0.736842105263158
2019-11-16,Hawaii,181,30,66,277,0.7725631768953068
2019-11-16,Arkansas,204,43,96,343,0.7346938775510203
2019-11-16,Iowa,49,10,20,79,0.7468354430379747
2019-11-16,Alabama,358,82,149,589,0.734295415959253
2019-11-16,Louisiana,99,18,40,157,0.7579617834394904
2019-11-16,New York,68,13,29,110,0.75
2019-11-16,Florida,127,39,47,213,0.7065727699530516
2019-11-16,Kansas,14,8,8,30,0.6
2019-11-16,Colorado,201,26,79,306,0.7859477124183006
2019-11-16,California,315,67,132,514,0.7412451361867705
2019-11-16,Nebraska,194,36,78,308,0.7564935064935066
2019-11-16,Delaware,71,16,31,118,0.733050847457627
2019-11-16,Washington,51,6,14,71,0.8169014084507042
2019-11-16,Massachusetts,109,13,40,162,0.7962962962962963
2019-11-16,Illinois,74,14,36,124,0.7419354838709677
2019-11-16,Utah,11,1,10,22,0.7272727272727273
2019-11-16,North Carolina,16,3,7,26,0.75
2019-11-16,Georgia,78,35,39,152,0.6414473684210527
2019-11-16,Pennsylvania,20,3,5,28,0.8035714285714286
2019-11-16,Michigan,23,8,5,36,0.7083333333333333
2019-11-16,Kentucky,13,2,1,16,0.84375
2019-11-16,South Dakota,1,0,0,1,1.0
2019-11-16,Arizona,54,7,31,92,0.7554347826086957
2019-11-16,Connecticut,16,2,6,24,0.7916666666666666
2019-11-16,Ohio,4,1,1,6,0.75
2019-11-16,Maryland,2,0,1,3,0.8333333333333333
2019-11-16,Missouri,30,3,11,44,0.8068181818181818
2019-11-16,Maine,15,2,4,21,0.8095238095238095
2019-11-16,Virginia,6,1,3,10,0.75
2019-11-16,Idaho,17,5,9,31,0.6935483870967741
2019-11-16,Oklahoma,5,1,3,9,0.7222222222222222
2019-11-16,South Carolina,4,1,0,5,0.8
2019-11-16,North Dakota,9,2,2,13,0.7692307692307692
2019-11-16,Montana,6,1,0,7,0.8571428571428571
2019-11-16,New Mexico,2,0,2,4,0.75
2019-11-16,Mississippi,1,1,1,3,0.5
2019-11-16,Minnesota,4,1,5,10,0.65
2019-11-16,Wisconsin,5,0,0,5,1.0
2019-11-16,New Hampshire,3,1,3,7,0.6428571428571428
2019-11-16,Tennessee,2,1,1,4,0.625
2019-11-16,Nevada,1,1,0,2,0.5
2019-11-16,West Virginia,0,0,1,1,0.5
2019-11-16,Rhode Island,1,0,0,1,1.0
2019-11-15,New York,143,62,112,317,0.6277602523659307
2019-11-15,Arkansas,410,167,245,822,0.6478102189781022
2019-11-15,Georgia,184,96,151,431,0.6020881670533642
2019-11-15,Colorado,374,157,256,787,0.6378653113087676
2019-11-15,Illinois,179,55,115,349,0.6776504297994269
2019-11-15,California,681,268,467,1416,0.6458333333333333
2019-11-15,Kansas,55,18,28,101,0.6831683168316832
2019-11-15,Florida,359,164,226,749,0.630173564753004
2019-11-15,Alabama,749,301,438,1488,0.6505376344086022
2019-11-15,Indiana,406,158,238,802,0.6546134663341646
2019-11-15,Texas,146,138,148,432,0.5092592592592593
2019-11-15,Arizona,136,59,83,278,0.6384892086330936
2019-11-15,Hawaii,501,145,237,883,0.70158550396376
2019-11-15,Nebraska,588,185,310,1083,0.6860572483841182
2019-11-15,North Carolina,33,12,23,68,0.6544117647058824
2019-11-15,Pennsylvania,78,18,30,126,0.7380952380952381
2019-11-15,Wisconsin,15,4,5,24,0.7291666666666666
2019-11-15,Kentucky,14,12,11,37,0.5270270270270271
2019-11-15,Missouri,85,36,67,188,0.6303191489361702
2019-11-15,Delaware,146,46,93,285,0.6754385964912282
2019-11-15,Oregon,82,43,68,193,0.6010362694300518
2019-11-15,Maryland,72,12,28,112,0.7678571428571429
2019-11-15,Iowa,113,63,76,252,0.5992063492063492
2019-11-15,Louisiana,206,77,163,446,0.6446188340807175
2019-11-15,Utah,20,8,11,39,0.6538461538461537
2019-11-15,Washington,79,29,75,183,0.6366120218579234
2019-11-15,Massachusetts,221,73,137,431,0.6716937354988399
2019-11-15,Alaska,99,46,68,213,0.6244131455399061
2019-11-15,Minnesota,19,10,13,42,0.6071428571428572
2019-11-15,Michigan,39,27,34,100,0.56
2019-11-15,Idaho,41,29,22,92,0.5652173913043478
2019-11-15,New Jersey,36,8,19,63,0.7222222222222222
2019-11-15,Connecticut,52,10,29,91,0.7307692307692307
2019-11-15,Montana,6,4,1,11,0.5909090909090908
2019-11-15,Virginia,18,8,9,35,0.6428571428571428
2019-11-15,Maine,28,9,15,52,0.6826923076923077
2019-11-15,North Dakota,6,5,7,18,0.5277777777777778
2019-11-15,West Virginia,2,7,2,11,0.2727272727272727
2019-11-15,Oklahoma,8,5,10,23,0.5652173913043478
2019-11-15,Rhode Island,1,3,5,9,0.3888888888888889
2019-11-15,Nevada,5,4,3,12,0.5416666666666667
2019-11-15,New Mexico,7,2,3,12,0.7083333333333334
2019-11-15,Mississippi,6,1,1,8,0.8125
2019-11-15,Ohio,6,6,12,24,0.5
2019-11-15,South Carolina,2,1,3,6,0.5833333333333333
2019-11-15,Tennessee,1,3,2,6,0.3333333333333333
2019-11-15,South Dakota,1,1,2,4,0.5
2019-11-15,Vermont,8,0,3,11,0.8636363636363636
2019-11-15,New Hampshire,3,1,2,6,0.6666666666666666
2019-11-14,Louisiana,52,34,29,115,0.5782608695652174
2019-11-14,Nebraska,153,44,85,282,0.6932624113475176
2019-11-14,Florida,105,59,44,208,0.610576923076923
2019-11-14,Texas,52,58,43,153,0.4803921568627451
2019-11-14,California,199,105,111,415,0.6132530120481927
2019-11-14,Arkansas,150,72,80,302,0.6291390728476821
2019-11-14,Georgia,62,51,46,159,0.5345911949685535
2019-11-14,Alabama,219,140,115,474,0.5833333333333334
2019-11-14,Indiana,125,51,79,255,0.6450980392156862
2019-11-14,Missouri,12,16,10,38,0.4473684210526315
2019-11-14,Colorado,83,60,64,207,0.5555555555555556
2019-11-14,Hawaii,123,56,96,275,0.6218181818181818
2019-11-14,Iowa,33,18,16,67,0.6119402985074627
2019-11-14,Massachusetts,102,17,43,162,0.7623456790123457
2019-11-14,Oregon,23,10,13,46,0.6413043478260869
2019-11-14,North Carolina,18,9,8,35,0.6285714285714286
2019-11-14,North Dakota,5,1,2,8,0.75
2019-11-14,New York,49,24,21,94,0.6329787234042553
2019-11-14,Utah,4,3,3,10,0.55
2019-11-14,Illinois,54,37,32,123,0.5691056910569106
2019-11-14,Kansas,18,4,3,25,0.78
2019-11-14,Alaska,36,19,16,71,0.6197183098591549
2019-11-14,New Jersey,19,6,8,33,0.696969696969697
2019-11-14,Maine,5,5,9,19,0.5
2019-11-14,Wisconsin,6,3,3,12,0.625
2019-11-14,Michigan,14,9,16,39,0.5641025641025641
2019-11-14,Pennsylvania,20,5,6,31,0.7419354838709677
2019-11-14,South Carolina,1,1,3,5,0.5
2019-11-14,Connecticut,8,3,5,16,0.65625
2019-11-14,Maryland,6,2,2,10,0.7
2019-11-14,Arizona,33,18,18,69,0.6086956521739131
2019-11-14,Ohio,8,2,2,12,0.75
2019-11-14,Idaho,5,3,4,12,0.5833333333333334
2019-11-14,Delaware,46,21,22,89,0.6404494382022472
2019-11-14,Kentucky,6,6,6,18,0.5
2019-11-14,Oklahoma,4,1,0,5,0.8
2019-11-14,Washington,30,18,15,63,0.5952380952380952
2019-11-14,New Mexico,4,2,1,7,0.6428571428571428
2019-11-14,Nevada,4,0,1,5,0.9
2019-11-14,Minnesota,6,4,1,11,0.5909090909090908
2019-11-14,New Hampshire,5,0,2,7,0.8571428571428572
2019-11-14,Rhode Island,0,1,2,3,0.3333333333333333
2019-11-14,Virginia,3,1,2,6,0.6666666666666666
2019-11-14,Mississippi,3,0,1,4,0.875
2019-11-14,Montana,4,2,0,6,0.6666666666666666
2019-11-14,Vermont,1,0,0,1,1.0
2019-11-14,Tennessee,1,1,0,2,0.5
2019-11-13,Arkansas,95,57,89,241,0.5788381742738589
2019-11-13,Alabama,226,99,147,472,0.6345338983050848
2019-11-13,Georgia,50,37,47,134,0.5485074626865671
2019-11-13,California,177,66,119,362,0.6533149171270718
2019-11-13,New Jersey,7,4,3,14,0.6071428571428571
2019-11-13,Ohio,3,3,0,6,0.5
2019-11-13,Oregon,21,14,24,59,0.5593220338983051
2019-11-13,Nebraska,150,40,95,285,0.6929824561403508
2019-11-13,Illinois,52,26,37,115,0.6130434782608696
2019-11-13,Colorado,114,43,63,220,0.6613636363636364
2019-11-13,Washington,25,8,14,47,0.6808510638297872
2019-11-13,Louisiana,56,18,41,115,0.6652173913043479
2019-11-13,Delaware,22,12,20,54,0.5925925925925926
2019-11-13,Massachusetts,74,20,46,140,0.6928571428571428
2019-11-13,Iowa,27,20,25,72,0.5486111111111112
2019-11-13,Alaska,25,12,14,51,0.6274509803921569
2019-11-13,New York,46,21,25,92,0.6358695652173914
2019-11-13,Texas,40,58,43,141,0.43617021276595747
2019-11-13,Idaho,5,6,8,19,0.47368421052631576
2019-11-13,Maine,2,4,4,10,0.4
2019-11-13,Hawaii,137,35,56,228,0.7236842105263157
2019-11-13,Arizona,25,16,21,62,0.5725806451612903
2019-11-13,Florida,51,42,50,143,0.5314685314685315
2019-11-13,Michigan,9,13,10,32,0.4375
2019-11-13,Indiana,106,47,69,222,0.6328828828828829
2019-11-13,Missouri,14,3,7,24,0.7291666666666667
2019-11-13,Connecticut,6,2,9,17,0.6176470588235294
2019-11-13,New Hampshire,1,4,2,7,0.2857142857142857
2019-11-13,North Carolina,17,3,14,34,0.7058823529411764
2019-11-13,Utah,5,4,3,12,0.5416666666666667
2019-11-13,Minnesota,6,2,3,11,0.6818181818181818
2019-11-13,Maryland,35,3,13,51,0.8137254901960784
2019-11-13,Kansas,12,5,9,26,0.6346153846153846
2019-11-13,Montana,0,1,2,3,0.3333333333333333
2019-11-13,Kentucky,6,7,8,21,0.47619047619047616
2019-11-13,Mississippi,1,1,0,2,0.5
2019-11-13,Virginia,1,2,5,8,0.4375
2019-11-13,Nevada,2,0,5,7,0.6428571428571428
2019-11-13,South Carolina,1,3,0,4,0.25
2019-11-13,Oklahoma,5,0,2,7,0.8571428571428572
2019-11-13,Pennsylvania,14,5,10,29,0.6551724137931034
2019-11-13,New Mexico,2,1,2,5,0.6000000000000001
2019-11-13,Wisconsin,3,1,2,6,0.6666666666666666
2019-11-13,Rhode Island,1,0,0,1,1.0
2019-11-13,Tennessee,0,1,1,2,0.25
2019-11-13,West Virginia,1,0,1,2,0.75
2019-11-13,North Dakota,0,0,1,1,0.5
2019-11-12,Indiana,70,39,64,173,0.5895953757225434
2019-11-12,Iowa,25,15,19,59,0.5847457627118644
2019-11-12,Hawaii,69,27,47,143,0.6468531468531469
2019-11-12,Mississippi,1,2,1,4,0.375
2019-11-12,Louisiana,51,12,25,88,0.7215909090909092
2019-11-12,Colorado,80,37,49,166,0.6295180722891567
2019-11-12,Idaho,8,6,4,18,0.5555555555555556
2019-11-12,Illinois,42,23,29,94,0.601063829787234
2019-11-12,Ohio,7,3,1,11,0.6818181818181818
2019-11-12,Florida,55,39,31,125,0.5640000000000001
2019-11-12,Michigan,16,8,10,34,0.6176470588235294
2019-11-12,Kentucky,6,3,8,17,0.5882352941176471
2019-11-12,Massachusetts,40,21,25,86,0.6104651162790697
2019-11-12,Rhode Island,2,1,2,5,0.6000000000000001
2019-11-12,Arkansas,83,39,67,189,0.6164021164021164
2019-11-12,Georgia,55,22,37,114,0.6447368421052632
2019-11-12,New Jersey,11,0,4,15,0.8666666666666666
2019-11-12,Delaware,30,10,13,53,0.6886792452830188
2019-11-12,Nebraska,87,35,61,183,0.6420765027322404
2019-11-12,Connecticut,10,2,2,14,0.7857142857142857
2019-11-12,Alabama,181,89,118,388,0.6185567010309279
2019-11-12,Arizona,27,26,18,71,0.5070422535211268
2019-11-12,Missouri,13,8,11,32,0.578125
2019-11-12,California,151,64,91,306,0.6421568627450981
2019-11-12,Texas,53,43,55,151,0.5331125827814569
2019-11-12,Minnesota,3,4,1,8,0.4375
2019-11-12,New York,20,8,22,50,0.62
2019-11-12,Washington,27,6,13,46,0.7282608695652174
2019-11-12,Alaska,28,9,16,53,0.6792452830188679
2019-11-12,Kansas,6,4,10,20,0.55
2019-11-12,Pennsylvania,10,4,9,23,0.6304347826086957
2019-11-12,South Dakota,1,0,0,1,1.0
2019-11-12,Oregon,11,16,6,33,0.4242424242424242
2019-11-12,Maryland,2,3,5,10,0.45
2019-11-12,Tennessee,1,3,0,4,0.25
2019-11-12,North Carolina,3,3,2,8,0.5
2019-11-12,Oklahoma,3,2,0,5,0.6
2019-11-12,Maine,4,0,2,6,0.8333333333333333
2019-11-12,Utah,4,5,5,14,0.4642857142857143
2019-11-12,Virginia,2,1,3,6,0.5833333333333333
2019-11-12,New Mexico,1,1,1,3,0.5
2019-11-12,South Carolina,1,2,1,4,0.375
2019-11-12,New Hampshire,0,2,0,2,0.0
2019-11-12,Nevada,2,0,1,3,0.8333333333333333
2019-11-12,Wisconsin,1,0,0,1,1.0
2019-11-12,West Virginia,1,0,0,1,1.0
2019-11-12,Montana,0,0,1,1,0.5
2019-11-11,Hawaii,17,4,11,32,0.703125
2019-11-11,California,25,12,15,52,0.625
2019-11-11,Kansas,1,3,1,5,0.30000000000000004
2019-11-11,Florida,5,5,7,17,0.5
2019-11-11,Illinois,5,1,11,17,0.6176470588235294
2019-11-11,New York,5,2,2,9,0.6666666666666667
2019-11-11,Arkansas,9,5,11,25,0.58
2019-11-11,Louisiana,4,2,4,10,0.6000000000000001
2019-11-11,Oregon,1,0,3,4,0.625
2019-11-11,Michigan,3,2,3,8,0.5625
2019-11-11,Indiana,9,4,8,21,0.6190476190476191
2019-11-11,Alabama,15,7,12,34,0.6176470588235294
2019-11-11,Nebraska,4,1,5,10,0.65
2019-11-11,Delaware,6,5,4,15,0.5333333333333333
2019-11-11,Colorado,4,6,8,18,0.4444444444444444
2019-11-11,Alaska,0,1,4,5,0.4
2019-11-11,Missouri,2,1,1,4,0.625
2019-11-11,Iowa,2,1,6,9,0.5555555555555556
2019-11-11,Georgia,2,1,2,5,0.6000000000000001
2019-11-11,Washington,3,6,0,9,0.3333333333333333
2019-11-11,Maryland,2,0,0,2,1.0
2019-11-11,Massachusetts,7,2,6,15,0.6666666666666667
2019-11-11,Kentucky,2,1,0,3,0.6666666666666666
2019-11-11,Arizona,2,3,1,6,0.41666666666666663
2019-11-11,Minnesota,1,0,1,2,0.75
2019-11-11,Pennsylvania,1,2,0,3,0.3333333333333333
2019-11-11,Texas,1,1,3,5,0.5
2019-11-11,Idaho,3,0,0,3,1.0
2019-11-11,North Carolina,1,0,0,1,1.0
2019-11-11,New Jersey,1,0,0,1,1.0
2019-11-11,Connecticut,1,0,0,1,1.0
2019-11-11,Ohio,0,1,0,1,0.0
2019-11-11,Maine,0,1,1,2,0.25
2019-11-11,Mississippi,0,0,2,2,0.5
2019-11-11,North Dakota,0,1,0,1,0.0
2019-11-10,California,177,82,122,381,0.6246719160104988
2019-11-10,Colorado,88,49,56,193,0.6010362694300518
2019-11-10,Maryland,3,5,1,9,0.38888888888888884
2019-11-10,Massachusetts,54,12,53,119,0.6764705882352942
2019-11-10,Ohio,6,2,3,11,0.6818181818181818
2019-11-10,Georgia,63,30,50,143,0.6153846153846154
2019-11-10,Louisiana,62,28,41,131,0.6297709923664122
2019-11-10,Hawaii,90,30,56,176,0.6704545454545454
2019-11-10,Connecticut,11,3,9,23,0.6739130434782609
2019-11-10,Wisconsin,1,2,2,5,0.4
2019-11-10,Arkansas,108,59,91,258,0.5949612403100776
2019-11-10,Florida,65,35,48,148,0.6013513513513513
2019-11-10,Idaho,9,6,8,23,0.5652173913043479
2019-11-10,Alabama,222,84,131,437,0.6578947368421053
2019-11-10,Indiana,108,44,57,209,0.65311004784689
2019-11-10,Alaska,25,14,15,54,0.6018518518518519
2019-11-10,Nebraska,84,39,58,181,0.6243093922651933
2019-11-10,Pennsylvania,9,8,13,30,0.5166666666666666
2019-11-10,Illinois,35,20,20,75,0.6
2019-11-10,Missouri,9,5,19,33,0.5606060606060606
2019-11-10,Iowa,30,22,12,64,0.5625
2019-11-10,New York,29,13,33,75,0.6066666666666667
2019-11-10,Michigan,11,13,8,32,0.46875
2019-11-10,Delaware,34,12,30,76,0.6447368421052632
2019-11-10,Tennessee,1,2,2,5,0.4
2019-11-10,Arizona,30,11,25,66,0.6439393939393939
2019-11-10,Washington,31,13,35,79,0.6139240506329113
2019-11-10,Texas,54,42,39,135,0.5444444444444445
2019-11-10,Maine,6,3,3,12,0.625
2019-11-10,Utah,8,3,7,18,0.6388888888888888
2019-11-10,Oregon,16,10,15,41,0.5731707317073171
2019-11-10,Kentucky,3,3,7,13,0.5
2019-11-10,Kansas,14,6,11,31,0.6290322580645161
2019-11-10,North Carolina,5,1,5,11,0.6818181818181818
2019-11-10,Mississippi,5,2,1,8,0.6875
2019-11-10,South Carolina,0,2,1,3,0.16666666666666666
2019-11-10,New Jersey,9,1,8,18,0.7222222222222222
2019-11-10,Minnesota,3,6,4,13,0.38461538461538464
2019-11-10,Virginia,5,1,2,8,0.75
2019-11-10,Oklahoma,4,0,4,8,0.75
2019-11-10,Nevada,2,2,1,5,0.5
2019-11-10,North Dakota,4,0,0,4,1.0
2019-11-10,Rhode Island,0,0,1,1,0.5
2019-11-10,West Virginia,1,0,0,1,1.0
2019-11-10,Montana,2,0,0,2,1.0
2019-11-09,California,431,203,379,1013,0.6125370187561698
2019-11-09,Utah,26,13,24,63,0.6031746031746031
2019-11-09,Alabama,579,287,501,1367,0.6068032187271397
2019-11-09,Arizona,82,63,82,227,0.5418502202643172
2019-11-09,Colorado,275,156,222,653,0.5911179173047473
2019-11-09,Arkansas,321,198,293,812,0.5757389162561576
2019-11-09,Nebraska,440,147,287,874,0.6676201372997712
2019-11-09,Texas,147,141,186,474,0.5063291139240507
2019-11-09,Ohio,9,7,7,23,0.5434782608695652
2019-11-09,Indiana,285,152,265,702,0.5947293447293447
2019-11-09,Florida,189,135,190,514,0.5525291828793775
2019-11-09,Hawaii,294,122,254,670,0.6283582089552239
2019-11-09,Louisiana,159,67,112,338,0.636094674556213
2019-11-09,Nevada,6,3,5,14,0.6071428571428571
2019-11-09,Illinois,128,68,117,313,0.5958466453674122
2019-11-09,Alaska,71,30,62,163,0.6257668711656441
2019-11-09,Kentucky,14,11,14,39,0.5384615384615384
2019-11-09,Delaware,105,44,76,225,0.6355555555555555
2019-11-09,Georgia,141,104,152,397,0.5465994962216625
2019-11-09,New York,104,43,94,241,0.6265560165975104
2019-11-09,Minnesota,13,5,8,26,0.6538461538461539
2019-11-09,Maine,13,6,16,35,0.6
2019-11-09,Kansas,32,15,24,71,0.619718309859155
2019-11-09,Oregon,76,46,60,182,0.5824175824175825
2019-11-09,New Hampshire,1,4,5,10,0.35
2019-11-09,Massachusetts,144,64,97,305,0.6311475409836066
2019-11-09,Iowa,83,33,90,206,0.6213592233009708
2019-11-09,Pennsylvania,28,17,36,81,0.5679012345679012
2019-11-09,Washington,64,38,52,154,0.5844155844155845
2019-11-09,New Jersey,24,8,19,51,0.6568627450980392
2019-11-09,North Carolina,18,12,17,47,0.5638297872340425
2019-11-09,Michigan,41,32,19,92,0.5489130434782609
2019-11-09,Missouri,34,29,30,93,0.5268817204301075
2019-11-09,Connecticut,32,12,24,68,0.6470588235294118
2019-11-09,Idaho,19,15,21,55,0.5363636363636364
2019-11-09,New Mexico,3,3,3,9,0.5
2019-11-09,South Carolina,5,1,1,7,0.7857142857142857
2019-11-09,Virginia,6,3,5,14,0.6071428571428571
2019-11-09,Oklahoma,2,6,7,15,0.3666666666666667
2019-11-09,Maryland,10,5,7,22,0.6136363636363636
2019-11-09,Tennessee,2,3,4,9,0.4444444444444444
2019-11-09,Montana,3,1,7,11,0.5909090909090908
2019-11-09,North Dakota,12,1,5,18,0.8055555555555556
2019-11-09,South Dakota,1,0,0,1,1.0
2019-11-09,Rhode Island,5,5,2,12,0.5
2019-11-09,West Virginia,0,3,0,3,0.0
2019-11-09,Wisconsin,1,4,9,14,0.3928571428571429
2019-11-09,Mississippi,5,3,8,16,0.5625
2019-11-09,Wyoming,0,0,1,1,0.5
2019-11-08,Kansas,4,2,1,7,0.6428571428571428
2019-11-08,Alabama,117,51,60,228,0.6447368421052632
2019-11-08,Illinois,26,13,18,57,0.6140350877192982
2019-11-08,Indiana,53,24,41,118,0.6228813559322034
2019-11-08,Hawaii,75,21,47,143,0.6888111888111887
2019-11-08,California,118,40,83,241,0.6618257261410788
2019-11-08,Ohio,3,1,2,6,0.6666666666666666
2019-11-08,Washington,18,4,12,34,0.7058823529411765
2019-11-08,Michigan,13,8,5,26,0.5961538461538461
2019-11-08,Texas,36,29,22,87,0.5402298850574713
2019-11-08,Colorado,58,27,23,108,0.6435185185185186
2019-11-08,Arkansas,72,45,64,181,0.574585635359116
2019-11-08,New Mexico,2,0,0,2,1.0
2019-11-08,Alaska,15,11,6,32,0.5625
2019-11-08,Missouri,11,2,6,19,0.736842105263158
2019-11-08,Massachusetts,40,11,35,86,0.6686046511627907
2019-11-08,Idaho,6,0,4,10,0.8
2019-11-08,South Carolina,0,2,0,2,0.0
2019-11-08,Minnesota,1,1,2,4,0.5
2019-11-08,Oregon,26,6,9,41,0.7439024390243902
2019-11-08,Louisiana,28,7,12,47,0.7234042553191489
2019-11-08,Maryland,0,4,2,6,0.16666666666666666
2019-11-08,Connecticut,4,2,4,10,0.6000000000000001
2019-11-08,Delaware,23,8,18,49,0.653061224489796
2019-11-08,Kentucky,4,6,8,18,0.4444444444444444
2019-11-08,North Carolina,3,2,3,8,0.5625
2019-11-08,Nebraska,45,26,32,103,0.5922330097087378
2019-11-08,Iowa,11,9,6,26,0.5384615384615384
2019-11-08,New York,15,5,9,29,0.6724137931034483
2019-11-08,Florida,36,20,28,84,0.5952380952380952
2019-11-08,Arizona,13,11,15,39,0.5256410256410257
2019-11-08,Georgia,34,14,15,63,0.6587301587301587
2019-11-08,Pennsylvania,4,5,4,13,0.46153846153846156
2019-11-08,North Dakota,0,1,1,2,0.25
2019-11-08,Virginia,3,1,2,6,0.6666666666666666
2019-11-08,Montana,0,1,0,1,0.0
2019-11-08,New Hampshire,1,0,2,3,0.6666666666666666
2019-11-08,Oklahoma,0,1,1,2,0.25
2019-11-08,Mississippi,1,1,0,2,0.5
2019-11-08,Utah,1,2,3,6,0.41666666666666663
2019-11-08,New Jersey,2,1,3,6,0.5833333333333333
2019-11-08,Wisconsin,0,0,1,1,0.5
2019-11-08,Tennessee,1,2,0,3,0.3333333333333333
2019-11-08,Maine,2,0,1,3,0.8333333333333333
2019-11-08,Nevada,1,0,0,1,1.0
2019-11-07,Nebraska,47,27,51,125,0.58
2019-11-07,California,154,58,99,311,0.6543408360128617
2019-11-07,Colorado,59,28,59,146,0.6061643835616438
2019-11-07,Alabama,125,70,111,306,0.5898692810457516
2019-11-07,Hawaii,48,22,56,126,0.6031746031746031
2019-11-07,New Jersey,4,1,2,7,0.7142857142857142
2019-11-07,Texas,34,29,25,88,0.5284090909090909
2019-11-07,Arkansas,67,52,124,243,0.5308641975308642
2019-11-07,Massachusetts,42,20,30,92,0.6195652173913043
2019-11-07,Arizona,24,20,22,66,0.5303030303030303
2019-11-07,New York,23,10,17,50,0.63
2019-11-07,Georgia,19,30,35,84,0.43452380952380953
2019-11-07,Michigan,8,4,10,22,0.5909090909090909
2019-11-07,Louisiana,32,15,25,72,0.6180555555555556
2019-11-07,Iowa,19,9,11,39,0.6282051282051282
2019-11-07,Kansas,7,7,6,20,0.5
2019-11-07,Indiana,64,26,41,131,0.6450381679389313
2019-11-07,Delaware,18,13,19,50,0.55
2019-11-07,Florida,29,33,36,98,0.47959183673469385
2019-11-07,Oregon,11,10,22,43,0.5116279069767442
2019-11-07,Washington,17,10,14,41,0.5853658536585366
2019-11-07,Montana,0,1,1,2,0.25
2019-11-07,Illinois,36,12,37,85,0.6411764705882352
2019-11-07,Pennsylvania,14,4,7,25,0.7000000000000001
2019-11-07,Missouri,9,2,2,13,0.7692307692307692
2019-11-07,Ohio,3,3,2,8,0.5
2019-11-07,Alaska,11,6,11,28,0.5892857142857143
2019-11-07,North Carolina,6,8,8,22,0.45454545454545453
2019-11-07,Kentucky,2,2,3,7,0.5
2019-11-07,North Dakota,2,1,2,5,0.6000000000000001
2019-11-07,Minnesota,7,6,1,14,0.5357142857142857
2019-11-07,Maine,2,2,5,9,0.5
2019-11-07,Mississippi,1,1,0,2,0.5
2019-11-07,Nevada,2,1,0,3,0.6666666666666666
2019-11-07,Utah,3,1,4,8,0.625
2019-11-07,Connecticut,7,1,5,13,0.7307692307692307
2019-11-07,Maryland,4,2,0,6,0.6666666666666666
2019-11-07,South Carolina,2,0,0,2,1.0
2019-11-07,Idaho,6,2,2,10,0.7
2019-11-07,New Hampshire,1,1,1,3,0.5
2019-11-07,New Mexico,1,0,0,1,1.0
2019-11-07,Wisconsin,2,1,0,3,0.6666666666666666
2019-11-07,Oklahoma,2,2,2,6,0.5
2019-11-07,Virginia,1,1,0,2,0.5
2019-11-07,Rhode Island,0,0,1,1,0.5
2019-11-06,Colorado,130,43,54,227,0.6916299559471366
2019-11-06,Florida,71,43,34,148,0.5945945945945946
2019-11-06,Illinois,65,26,34,125,0.656
2019-11-06,California,305,91,138,534,0.7003745318352059
2019-11-06,Indiana,176,63,94,333,0.6696696696696697
2019-11-06,Massachusetts,90,20,35,145,0.7413793103448276
2019-11-06,Arizona,59,21,25,105,0.680952380952381
2019-11-06,Alabama,360,125,171,656,0.6791158536585367
2019-11-06,Alaska,30,15,18,63,0.6190476190476191
2019-11-06,Hawaii,164,47,71,282,0.7074468085106382
2019-11-06,Delaware,33,20,27,80,0.58125
2019-11-06,Nebraska,156,40,67,263,0.720532319391635
2019-11-06,New Jersey,12,8,6,26,0.576923076923077
2019-11-06,New York,57,10,37,104,0.7259615384615385
2019-11-06,Michigan,19,5,18,42,0.6666666666666666
2019-11-06,Idaho,18,4,9,31,0.7258064516129032
2019-11-06,Texas,82,49,52,183,0.5901639344262295
2019-11-06,Washington,51,9,24,84,0.75
2019-11-06,Georgia,70,39,56,165,0.593939393939394
2019-11-06,Minnesota,7,5,5,17,0.5588235294117647
2019-11-06,Arkansas,151,51,74,276,0.6811594202898551
2019-11-06,Louisiana,80,31,38,149,0.6644295302013423
2019-11-06,Iowa,27,16,21,64,0.5859375
2019-11-06,Pennsylvania,10,6,6,22,0.5909090909090908
2019-11-06,Maryland,8,5,2,15,0.6
2019-11-06,Ohio,7,4,2,13,0.6153846153846154
2019-11-06,Utah,1,7,3,11,0.22727272727272727
2019-11-06,Connecticut,16,3,10,29,0.7241379310344828
2019-11-06,North Carolina,6,0,4,10,0.8
2019-11-06,Kentucky,8,3,5,16,0.65625
2019-11-06,Kansas,17,9,7,33,0.6212121212121212
2019-11-06,Oregon,30,12,16,58,0.6551724137931034
2019-11-06,Missouri,22,10,22,54,0.611111111111111
2019-11-06,Wisconsin,9,0,1,10,0.9500000000000001
2019-11-06,Rhode Island,2,0,4,6,0.6666666666666666
2019-11-06,Montana,2,1,1,4,0.625
2019-11-06,Nevada,3,0,0,3,1.0
2019-11-06,New Hampshire,4,1,0,5,0.8
2019-11-06,South Dakota,1,0,1,2,0.75
2019-11-06,Maine,5,4,1,10,0.55
2019-11-06,North Dakota,4,2,2,8,0.625
2019-11-06,Virginia,10,2,1,13,0.8076923076923077
2019-11-06,New Mexico,3,1,1,5,0.7
2019-11-06,West Virginia,2,0,0,2,1.0
2019-11-06,Oklahoma,4,1,0,5,0.8
2019-11-06,South Carolina,1,0,0,1,1.0
2019-11-06,Tennessee,2,1,1,4,0.625
2019-11-06,Mississippi,0,1,0,1,0.0
2019-11-05,Indiana,235,57,103,395,0.7253164556962025
2019-11-05,Georgia,139,47,71,257,0.6789883268482491
2019-11-05,Arkansas,252,68,124,444,0.7072072072072072
2019-11-05,California,404,104,166,674,0.7225519287833828
2019-11-05,Louisiana,104,33,50,187,0.6898395721925134
2019-11-05,Texas,131,50,72,253,0.6600790513833992
2019-11-05,Alabama,451,127,199,777,0.7084942084942085
2019-11-05,Massachusetts,149,32,49,230,0.7543478260869565
2019-11-05,Michigan,38,8,14,60,0.75
2019-11-05,Hawaii,272,64,114,450,0.7311111111111112
2019-11-05,Ohio,6,3,5,14,0.6071428571428571
2019-11-05,Colorado,226,57,95,378,0.7235449735449736
2019-11-05,Nebraska,262,61,89,412,0.7439320388349515
2019-11-05,Oregon,50,19,14,83,0.6867469879518073
2019-11-05,Illinois,114,32,46,192,0.7135416666666666
2019-11-05,Washington,39,4,17,60,0.7916666666666667
2019-11-05,Florida,182,75,73,330,0.6621212121212121
2019-11-05,Virginia,8,4,5,17,0.6176470588235294
2019-11-05,Iowa,73,18,31,122,0.7254098360655737
2019-11-05,New Mexico,7,0,1,8,0.9375
2019-11-05,Pennsylvania,27,9,13,49,0.6836734693877551
2019-11-05,Missouri,59,8,18,85,0.7999999999999999
2019-11-05,Kansas,33,10,12,55,0.7090909090909091
2019-11-05,New York,111,19,39,169,0.7721893491124261
2019-11-05,Alaska,36,17,25,78,0.6217948717948718
2019-11-05,Idaho,33,5,10,48,0.7916666666666666
2019-11-05,Arizona,86,36,45,167,0.6497005988023952
2019-11-05,Delaware,91,19,31,141,0.7553191489361702
2019-11-05,Connecticut,23,5,6,34,0.7647058823529412
2019-11-05,Minnesota,17,4,5,26,0.75
2019-11-05,Mississippi,2,0,5,7,0.6428571428571428
2019-11-05,Utah,16,4,5,25,0.74
2019-11-05,New Jersey,12,10,3,25,0.54
2019-11-05,Kentucky,14,7,8,29,0.6206896551724138
2019-11-05,Rhode Island,4,0,3,7,0.7857142857142857
2019-11-05,Maryland,11,1,5,17,0.7941176470588236
2019-11-05,Maine,7,3,4,14,0.6428571428571428
2019-11-05,Nevada,7,5,1,13,0.5769230769230769
2019-11-05,Wisconsin,2,3,1,6,0.41666666666666663
2019-11-05,Tennessee,2,0,3,5,0.7
2019-11-05,Oklahoma,6,1,3,10,0.75
2019-11-05,Montana,2,0,2,4,0.75
2019-11-05,North Dakota,5,1,7,13,0.6538461538461539
2019-11-05,North Carolina,10,3,9,22,0.6590909090909091
2019-11-05,New Hampshire,4,1,1,6,0.75
2019-11-05,South Carolina,3,1,0,4,0.75
2019-11-05,Wyoming,1,0,0,1,1.0
2019-11-05,South Dakota,1,0,0,1,1.0
2019-11-04,Alabama,234,89,95,418,0.6734449760765551
2019-11-04,Washington,27,0,15,42,0.8214285714285715
2019-11-04,Hawaii,140,49,71,260,0.6749999999999999
2019-11-04,Arkansas,127,48,53,228,0.6732456140350876
2019-11-04,Florida,103,59,44,206,0.6067961165048543
2019-11-04,Georgia,72,22,43,137,0.6824817518248175
2019-11-04,Massachusetts,78,25,32,135,0.6962962962962962
2019-11-04,Indiana,126,44,56,226,0.6814159292035398
2019-11-04,Idaho,10,6,8,24,0.5833333333333334
2019-11-04,Louisiana,53,13,37,103,0.6941747572815534
2019-11-04,Missouri,20,8,11,39,0.6538461538461537
2019-11-04,Iowa,34,11,19,64,0.6796875
2019-11-04,Oregon,18,8,12,38,0.631578947368421
2019-11-04,Texas,49,39,43,131,0.5381679389312977
2019-11-04,Colorado,91,42,48,181,0.6353591160220995
2019-11-04,California,236,65,100,401,0.713216957605985
2019-11-04,Nebraska,100,32,70,202,0.6683168316831682
2019-11-04,Illinois,52,19,23,94,0.6755319148936171
2019-11-04,New Jersey,12,5,5,22,0.6590909090909091
2019-11-04,Oklahoma,4,3,1,8,0.5625
2019-11-04,New York,42,19,25,86,0.6337209302325582
2019-11-04,Wisconsin,2,3,3,8,0.4375
2019-11-04,Kansas,11,8,12,31,0.5483870967741935
2019-11-04,Utah,10,1,7,18,0.75
2019-11-04,Pennsylvania,14,4,5,23,0.7173913043478262
2019-11-04,Alaska,29,9,11,49,0.7040816326530612
2019-11-04,Michigan,12,8,11,31,0.564516129032258
2019-11-04,Delaware,31,14,21,66,0.6287878787878788
2019-11-04,Arizona,36,17,16,69,0.6376811594202898
2019-11-04,South Carolina,5,2,1,8,0.6875
2019-11-04,Kentucky,9,2,10,21,0.6666666666666666
2019-11-04,North Dakota,3,0,0,3,1.0
2019-11-04,Connecticut,5,3,6,14,0.5714285714285714
2019-11-04,Ohio,5,0,5,10,0.75
2019-11-04,Maine,4,2,3,9,0.611111111111111
2019-11-04,Rhode Island,0,1,0,1,0.0
2019-11-04,New Mexico,4,0,2,6,0.8333333333333333
2019-11-04,Tennessee,1,1,1,3,0.5
2019-11-04,Maryland,6,4,4,14,0.5714285714285714
2019-11-04,North Carolina,5,2,5,12,0.625
2019-11-04,Minnesota,9,0,2,11,0.9090909090909092
2019-11-04,Nevada,4,0,1,5,0.9
2019-11-04,New Hampshire,0,1,2,3,0.3333333333333333
2019-11-04,Virginia,6,3,1,10,0.65
2019-11-04,Montana,0,0,1,1,0.5
2019-11-04,Mississippi,1,0,1,2,0.75
2019-11-04,West Virginia,0,0,1,1,0.5
2019-11-04,Vermont,1,0,0,1,1.0
2019-11-03,Arkansas,85,36,66,187,0.6310160427807486
2019-11-03,Texas,44,29,31,104,0.5721153846153846
2019-11-03,California,181,49,72,302,0.7185430463576159
2019-11-03,Massachusetts,35,8,16,59,0.7288135593220338
2019-11-03,New York,13,5,22,40,0.6000000000000001
2019-11-03,Colorado,69,21,37,127,0.6889763779527559
2019-11-03,Iowa,21,9,9,39,0.6538461538461539
2019-11-03,Arizona,17,19,23,59,0.48305084745762716
2019-11-03,Virginia,4,3,0,7,0.5714285714285714
2019-11-03,Indiana,61,27,37,125,0.636
2019-11-03,Alabama,180,61,85,326,0.6825153374233129
2019-11-03,Delaware,18,8,13,39,0.6282051282051282
2019-11-03,Connecticut,5,0,5,10,0.75
2019-11-03,Florida,58,28,33,119,0.6260504201680672
2019-11-03,Hawaii,66,22,27,115,0.691304347826087
2019-11-03,Georgia,41,18,29,88,0.6306818181818181
2019-11-03,Louisiana,38,6,20,64,0.75
2019-11-03,North Carolina,7,3,1,11,0.6818181818181818
2019-11-03,Illinois,30,17,20,67,0.5970149253731343
2019-11-03,Oregon,11,3,13,27,0.6481481481481481
2019-11-03,Maine,2,2,1,5,0.5
2019-11-03,Kansas,5,3,4,12,0.5833333333333334
2019-11-03,Nebraska,59,22,27,108,0.6712962962962963
2019-11-03,Washington,9,5,2,16,0.625
2019-11-03,Pennsylvania,6,5,3,14,0.5357142857142857
2019-11-03,Michigan,8,3,11,22,0.6136363636363636
2019-11-03,Alaska,17,5,10,32,0.6875
2019-11-03,New Jersey,6,4,5,15,0.5666666666666667
2019-11-03,Minnesota,5,1,3,9,0.7222222222222222
2019-11-03,Missouri,13,3,9,25,0.7
2019-11-03,Maryland,4,1,1,6,0.75
2019-11-03,Nevada,3,1,1,5,0.7
2019-11-03,Mississippi,4,0,1,5,0.9
2019-11-03,Rhode Island,1,0,0,1,1.0
2019-11-03,North Dakota,2,0,0,2,1.0
2019-11-03,Idaho,7,2,6,15,0.6666666666666667
2019-11-03,New Mexico,3,2,0,5,0.6
2019-11-03,Kentucky,11,1,4,16,0.8125
2019-11-03,Wisconsin,4,0,1,5,0.9
2019-11-03,Utah,2,0,2,4,0.75
2019-11-03,Oklahoma,2,1,0,3,0.6666666666666666
2019-11-03,South Carolina,1,1,0,2,0.5
2019-11-03,Ohio,2,0,2,4,0.75
2019-11-03,West Virginia,0,0,1,1,0.5
2019-11-03,Montana,1,1,0,2,0.5
2019-11-03,Tennessee,1,0,0,1,1.0
2019-11-02,Massachusetts,5,3,2,10,0.6
2019-11-02,Hawaii,2,5,6,13,0.38461538461538464
2019-11-02,Florida,5,7,5,17,0.4411764705882353
2019-11-02,New Jersey,1,1,1,3,0.5
2019-11-02,Alabama,12,13,4,29,0.48275862068965514
2019-11-02,New York,3,3,1,7,0.5
2019-11-02,Louisiana,5,3,6,14,0.5714285714285714
2019-11-02,Delaware,4,4,9,17,0.5
2019-11-02,Arkansas,17,14,13,44,0.5340909090909091
2019-11-02,Iowa,6,1,1,8,0.8125
2019-11-02,Alaska,6,0,7,13,0.7307692307692308
2019-11-02,California,23,11,20,54,0.6111111111111112
2019-11-02,Idaho,1,3,3,7,0.3571428571428571
2019-11-02,Connecticut,5,2,0,7,0.7142857142857143
2019-11-02,Arizona,1,3,6,10,0.4
2019-11-02,Texas,3,10,5,18,0.3055555555555556
2019-11-02,Colorado,5,1,9,15,0.6333333333333333
2019-11-02,Indiana,3,8,6,17,0.35294117647058826
2019-11-02,Maine,1,0,1,2,0.75
2019-11-02,Illinois,6,1,3,10,0.75
2019-11-02,Georgia,4,5,2,11,0.4545454545454546
2019-11-02,Michigan,2,0,1,3,0.8333333333333333
2019-11-02,Nebraska,1,2,1,4,0.375
2019-11-02,Pennsylvania,1,2,1,4,0.375
2019-11-02,Missouri,3,2,3,8,0.5625
2019-11-02,Kansas,0,0,1,1,0.5
2019-11-02,North Carolina,0,0,1,1,0.5
2019-11-02,Montana,0,1,0,1,0.0
2019-11-02,Ohio,4,0,0,4,1.0
2019-11-02,Oregon,1,0,0,1,1.0
2019-11-02,Nevada,1,0,0,1,1.0
2019-11-02,Maryland,1,0,1,2,0.75
2019-11-02,Washington,2,0,1,3,0.8333333333333333
2019-11-02,Mississippi,0,0,1,1,0.5
2019-11-02,Virginia,0,0,1,1,0.5
2019-11-01,California,48,16,24,88,0.6818181818181818
2019-11-01,South Carolina,1,0,1,2,0.75
2019-11-01,Arkansas,8,11,13,32,0.453125
2019-11-01,Michigan,1,0,1,2,0.75
2019-11-01,Iowa,4,1,3,8,0.6875
2019-11-01,Massachusetts,6,4,9,19,0.5526315789473684
2019-11-01,Florida,11,9,14,34,0.5294117647058824
2019-11-01,Alabama,16,7,12,35,0.6285714285714286
2019-11-01,Indiana,13,4,10,27,0.6666666666666666
2019-11-01,Delaware,3,4,8,15,0.4666666666666667
2019-11-01,Hawaii,10,1,10,21,0.7142857142857142
2019-11-01,Virginia,1,0,0,1,1.0
2019-11-01,New York,9,2,2,13,0.7692307692307692
2019-11-01,Missouri,2,2,3,7,0.5
2019-11-01,North Carolina,3,1,1,5,0.7
2019-11-01,Colorado,16,2,5,23,0.8043478260869565
2019-11-01,Alaska,6,2,5,13,0.6538461538461539
2019-11-01,Nebraska,1,2,4,7,0.42857142857142855
2019-11-01,Georgia,6,5,4,15,0.5333333333333333
2019-11-01,Pennsylvania,2,1,2,5,0.6000000000000001
2019-11-01,Louisiana,6,1,3,10,0.75
2019-11-01,North Dakota,0,1,1,2,0.25
2019-11-01,Arizona,4,4,3,11,0.5
2019-11-01,New Jersey,0,1,1,2,0.25
2019-11-01,Idaho,1,1,1,3,0.5
2019-11-01,Illinois,6,4,4,14,0.5714285714285714
2019-11-01,Texas,0,5,6,11,0.2727272727272727
2019-11-01,Washington,3,0,1,4,0.875
2019-11-01,Kansas,1,0,1,2,0.75
2019-11-01,Oregon,0,1,1,2,0.25
2019-11-01,Maryland,3,0,1,4,0.875
2019-11-01,Mississippi,0,0,1,1,0.5
2019-11-01,Wisconsin,1,0,0,1,1.0
2019-11-01,Connecticut,1,2,1,4,0.375
2019-11-01,Minnesota,1,0,0,1,1.0
2019-10-31,Alabama,19,12,17,48,0.5729166666666666
2019-10-31,Delaware,6,3,4,13,0.6153846153846154
2019-10-31,Georgia,3,0,8,11,0.6363636363636364
2019-10-31,Arkansas,9,14,20,43,0.4418604651162791
2019-10-31,California,27,15,25,67,0.5895522388059702
2019-10-31,Connecticut,3,0,1,4,0.875
2019-10-31,Hawaii,16,5,7,28,0.6964285714285714
2019-10-31,Colorado,11,4,10,25,0.64
2019-10-31,Louisiana,6,2,4,12,0.6666666666666666
2019-10-31,New Hampshire,0,0,1,1,0.5
2019-10-31,Oregon,2,1,2,5,0.6000000000000001
2019-10-31,Idaho,0,2,0,2,0.0
2019-10-31,Texas,3,0,8,11,0.6363636363636364
2019-10-31,Kansas,3,0,1,4,0.875
2019-10-31,New York,18,1,4,23,0.8695652173913044
2019-10-31,Wisconsin,2,0,0,2,1.0
2019-10-31,Maryland,3,0,1,4,0.875
2019-10-31,Indiana,11,4,7,22,0.6590909090909091
2019-10-31,Missouri,2,0,2,4,0.75
2019-10-31,Florida,7,6,8,21,0.5238095238095237
2019-10-31,Pennsylvania,1,0,1,2,0.75
2019-10-31,Arizona,2,2,4,8,0.5
2019-10-31,Illinois,5,5,7,17,0.5
2019-10-31,Massachusetts,10,5,10,25,0.6000000000000001
2019-10-31,Nebraska,4,2,6,12,0.5833333333333333
2019-10-31,Iowa,3,2,2,7,0.5714285714285714
2019-10-31,Kentucky,0,2,4,6,0.3333333333333333
2019-10-31,Alaska,1,2,3,6,0.41666666666666663
2019-10-31,Ohio,3,2,0,5,0.6
2019-10-31,Vermont,1,0,0,1,1.0
2019-10-31,Nevada,0,1,1,2,0.25
2019-10-31,Washington,3,2,1,6,0.5833333333333334
2019-10-31,Michigan,1,1,0,2,0.5
2019-10-31,North Carolina,1,1,1,3,0.5
2019-10-31,Virginia,3,1,0,4,0.75
2019-10-31,Minnesota,1,0,0,1,1.0
2019-10-30,Georgia,3,13,6,22,0.2727272727272727
2019-10-30,Alaska,3,3,4,10,0.5
2019-10-30,Arkansas,26,14,15,55,0.6090909090909091
2019-10-30,California,43,16,26,85,0.6588235294117647
2019-10-30,Indiana,14,8,10,32,0.59375
2019-10-30,Mississippi,0,1,0,1,0.0
2019-10-30,Delaware,8,9,4,21,0.47619047619047616
2019-10-30,Michigan,0,5,1,6,0.08333333333333333
2019-10-30,Kansas,0,1,2,3,0.3333333333333333
2019-10-30,Idaho,4,1,3,8,0.6875
2019-10-30,Alabama,15,8,13,36,0.5972222222222222
2019-10-30,Missouri,2,3,1,6,0.41666666666666663
2019-10-30,Arizona,9,3,5,17,0.6764705882352942
2019-10-30,Florida,11,9,11,31,0.532258064516129
2019-10-30,New Jersey,1,0,3,4,0.625
2019-10-30,Massachusetts,21,4,8,33,0.7575757575757576
2019-10-30,Hawaii,13,5,14,32,0.625
2019-10-30,Illinois,13,7,9,29,0.603448275862069
2019-10-30,Nevada,1,1,2,4,0.5
2019-10-30,Ohio,5,2,3,10,0.65
2019-10-30,Virginia,1,0,1,2,0.75
2019-10-30,Louisiana,10,4,5,19,0.6578947368421052
2019-10-30,Iowa,4,2,1,7,0.6428571428571428
2019-10-30,Colorado,13,3,6,22,0.7272727272727273
2019-10-30,New York,4,4,3,11,0.5
2019-10-30,Maryland,1,1,2,4,0.5
2019-10-30,Pennsylvania,11,2,3,16,0.78125
2019-10-30,Nebraska,3,3,2,8,0.5
2019-10-30,Oregon,3,1,0,4,0.75
2019-10-30,North Carolina,0,0,2,2,0.5
2019-10-30,Wisconsin,0,1,0,1,0.0
2019-10-30,Texas,3,3,6,12,0.5
2019-10-30,South Carolina,0,1,1,2,0.25
2019-10-30,Washington,2,5,3,10,0.35
2019-10-30,Utah,0,2,0,2,0.0
2019-10-30,Connecticut,2,0,1,3,0.8333333333333333
2019-10-30,Minnesota,0,0,1,1,0.5
2019-10-30,Kentucky,0,1,0,1,0.0
2019-10-30,Maine,0,1,1,2,0.25
2019-10-29,Texas,3,2,3,8,0.5625
2019-10-29,California,54,21,26,101,0.6633663366336634
2019-10-29,Massachusetts,16,6,8,30,0.6666666666666666
2019-10-29,Hawaii,16,6,11,33,0.6515151515151515
2019-10-29,Nevada,1,0,0,1,1.0
2019-10-29,Arkansas,23,10,10,43,0.6511627906976744
2019-10-29,Louisiana,9,3,1,13,0.7307692307692307
2019-10-29,Alabama,17,9,14,40,0.6
2019-10-29,Alaska,10,3,3,16,0.71875
2019-10-29,Illinois,5,6,13,24,0.47916666666666663
2019-10-29,Delaware,7,7,6,20,0.5
2019-10-29,Indiana,8,5,4,17,0.5882352941176471
2019-10-29,Maine,0,1,0,1,0.0
2019-10-29,New York,5,4,3,12,0.5416666666666667
2019-10-29,Connecticut,2,3,0,5,0.4
2019-10-29,Georgia,5,4,9,18,0.5277777777777778
2019-10-29,Kansas,0,2,1,3,0.16666666666666666
2019-10-29,Colorado,14,1,5,20,0.825
2019-10-29,Nebraska,3,3,2,8,0.5
2019-10-29,Oregon,0,2,3,5,0.3
2019-10-29,Missouri,3,3,1,7,0.5
2019-10-29,Florida,7,4,6,17,0.5882352941176471
2019-10-29,Arizona,5,2,2,9,0.6666666666666667
2019-10-29,Idaho,0,1,2,3,0.3333333333333333
2019-10-29,Ohio,1,3,3,7,0.3571428571428571
2019-10-29,New Mexico,1,0,0,1,1.0
2019-10-29,New Jersey,2,1,1,4,0.625
2019-10-29,Pennsylvania,8,2,2,12,0.75
2019-10-29,Wisconsin,0,0,1,1,0.5
2019-10-29,Michigan,0,0,2,2,0.5
2019-10-29,Washington,1,0,3,4,0.625
2019-10-29,Maryland,2,2,1,5,0.5
2019-10-29,North Carolina,1,0,0,1,1.0
2019-10-29,North Dakota,0,1,0,1,0.0
2019-10-29,Iowa,3,1,1,5,0.7
2019-10-29,Kentucky,0,0,1,1,0.5
2019-10-29,Mississippi,1,0,0,1,1.0
2019-10-29,Montana,0,0,1,1,0.5
2019-10-29,Minnesota,0,1,1,2,0.25
2019-10-28,Nebraska,3,3,4,10,0.5
2019-10-28,Michigan,5,3,1,9,0.6111111111111112
2019-10-28,Alabama,14,9,9,32,0.578125
2019-10-28,Idaho,1,1,2,4,0.5
2019-10-28,Georgia,4,4,4,12,0.5
2019-10-28,Arizona,3,5,4,12,0.41666666666666663
2019-10-28,Colorado,11,3,9,23,0.6739130434782609
2019-10-28,Texas,3,1,0,4,0.75
2019-10-28,California,31,21,28,80,0.5625
2019-10-28,Connecticut,0,1,2,3,0.3333333333333333
2019-10-28,Kansas,1,0,2,3,0.6666666666666666
2019-10-28,Missouri,3,0,3,6,0.75
2019-10-28,Arkansas,11,8,18,37,0.5405405405405406
2019-10-28,Florida,11,6,4,21,0.6190476190476191
2019-10-28,Hawaii,25,7,4,36,0.75
2019-10-28,Iowa,4,1,5,10,0.65
2019-10-28,Indiana,9,3,9,21,0.6428571428571428
2019-10-28,Massachusetts,13,4,8,25,0.68
2019-10-28,Maryland,4,1,2,7,0.7142857142857142
2019-10-28,New York,3,1,2,6,0.6666666666666666
2019-10-28,Alaska,9,0,7,16,0.78125
2019-10-28,Delaware,6,0,2,8,0.875
2019-10-28,Oregon,1,0,2,3,0.6666666666666666
2019-10-28,North Carolina,0,1,1,2,0.25
2019-10-28,Washington,5,2,2,9,0.6666666666666667
2019-10-28,Minnesota,0,2,0,2,0.0
2019-10-28,New Jersey,0,3,1,4,0.125
2019-10-28,Utah,0,0,1,1,0.5
2019-10-28,Pennsylvania,4,0,1,5,0.9
2019-10-28,Virginia,0,1,0,1,0.0
2019-10-28,Ohio,0,1,0,1,0.0
2019-10-28,Illinois,5,3,0,8,0.625
2019-10-28,Kentucky,0,3,0,3,0.0
2019-10-28,Louisiana,7,1,3,11,0.7727272727272727
2019-10-28,South Dakota,0,0,1,1,0.5
2019-10-28,Nevada,0,0,1,1,0.5
2019-10-27,Kansas,0,0,1,1,0.5
2019-10-27,Colorado,6,1,5,12,0.7083333333333334
2019-10-27,Alabama,12,5,11,28,0.625
2019-10-27,Arizona,2,1,2,5,0.6000000000000001
2019-10-27,Michigan,0,1,1,2,0.25
2019-10-27,California,29,11,27,67,0.6343283582089552
2019-10-27,Alaska,3,3,5,11,0.5
2019-10-27,Maryland,2,0,1,3,0.8333333333333333
2019-10-27,New York,7,0,5,12,0.7916666666666667
2019-10-27,Iowa,2,0,0,2,1.0
2019-10-27,Florida,7,3,6,16,0.625
2019-10-27,Hawaii,10,1,3,14,0.8214285714285714
2019-10-27,Delaware,5,3,2,10,0.6
2019-10-27,Connecticut,4,0,1,5,0.9
2019-10-27,Nebraska,5,1,2,8,0.75
2019-10-27,Arkansas,11,5,6,22,0.6363636363636364
2019-10-27,Illinois,4,1,2,7,0.7142857142857142
2019-10-27,Texas,0,2,2,4,0.25
2019-10-27,Louisiana,5,2,7,14,0.6071428571428572
2019-10-27,Nevada,1,0,1,2,0.75
2019-10-27,Georgia,1,2,2,5,0.4
2019-10-27,Oregon,4,1,2,7,0.7142857142857142
2019-10-27,Indiana,5,6,3,14,0.4642857142857143
2019-10-27,Massachusetts,8,1,3,12,0.7916666666666666
2019-10-27,Missouri,3,2,1,6,0.5833333333333334
2019-10-27,Pennsylvania,0,2,4,6,0.3333333333333333
2019-10-27,Washington,2,0,0,2,1.0
2019-10-27,South Carolina,1,0,0,1,1.0
2019-10-27,Kentucky,2,1,0,3,0.6666666666666666
2019-10-27,North Carolina,2,0,0,2,1.0
2019-10-27,Minnesota,0,0,3,3,0.5
2019-10-27,West Virginia,0,0,1,1,0.5
2019-10-27,Virginia,0,1,0,1,0.0
2019-10-27,New Jersey,1,0,3,4,0.625
2019-10-27,Oklahoma,1,0,0,1,1.0
2019-10-27,New Hampshire,0,0,1,1,0.5
2019-10-26,Arizona,3,2,1,6,0.5833333333333334
2019-10-26,Arkansas,8,6,11,25,0.54
2019-10-26,Georgia,8,3,6,17,0.6470588235294118
2019-10-26,California,25,13,9,47,0.6276595744680851
2019-10-26,Alabama,5,7,11,23,0.4565217391304348
2019-10-26,Iowa,7,2,1,10,0.75
2019-10-26,Alaska,4,0,2,6,0.8333333333333333
2019-10-26,Illinois,12,2,1,15,0.8333333333333334
2019-10-26,Massachusetts,5,1,1,7,0.7857142857142857
2019-10-26,Idaho,3,1,2,6,0.6666666666666666
2019-10-26,Hawaii,6,0,3,9,0.8333333333333333
2019-10-26,New York,3,1,1,5,0.7
2019-10-26,Florida,7,0,1,8,0.9375
2019-10-26,Colorado,6,2,3,11,0.6818181818181818
2019-10-26,Louisiana,6,3,0,9,0.6666666666666666
2019-10-26,Indiana,8,6,1,15,0.5666666666666667
2019-10-26,North Carolina,1,0,0,1,1.0
2019-10-26,Washington,2,2,3,7,0.5
2019-10-26,Connecticut,1,0,1,2,0.75
2019-10-26,Pennsylvania,1,1,1,3,0.5
2019-10-26,Texas,0,3,2,5,0.2
2019-10-26,Delaware,3,2,2,7,0.5714285714285714
2019-10-26,Missouri,4,2,0,6,0.6666666666666666
2019-10-26,Nebraska,1,0,2,3,0.6666666666666666
2019-10-26,Michigan,0,0,2,2,0.5
2019-10-26,Ohio,0,1,0,1,0.0
2019-10-26,Oregon,1,1,0,2,0.5
2019-10-26,Kentucky,0,1,0,1,0.0
2019-10-26,Oklahoma,0,0,1,1,0.5
2019-10-26,New Jersey,3,0,1,4,0.875
2019-10-26,Maryland,0,0,1,1,0.5
2019-10-26,Maine,0,1,0,1,0.0
2019-10-26,Kansas,0,0,1,1,0.5
2019-10-26,Minnesota,0,1,0,1,0.0
2019-10-25,Massachusetts,15,2,4,21,0.8095238095238095
2019-10-25,Alabama,21,8,12,41,0.6585365853658537
2019-10-25,Florida,4,4,7,15,0.5
2019-10-25,California,34,18,25,77,0.6038961038961039
2019-10-25,Oregon,2,0,1,3,0.8333333333333333
2019-10-25,Illinois,7,4,5,16,0.59375
2019-10-25,New Jersey,2,0,0,2,1.0
2019-10-25,Alaska,2,2,5,9,0.5
2019-10-25,Indiana,14,12,10,36,0.5277777777777778
2019-10-25,Louisiana,11,4,3,18,0.6944444444444445
2019-10-25,Idaho,0,0,2,2,0.5
2019-10-25,New York,4,2,3,9,0.611111111111111
2019-10-25,Maryland,2,1,1,4,0.625
2019-10-25,Georgia,4,2,4,10,0.6000000000000001
2019-10-25,Hawaii,10,3,5,18,0.6944444444444444
2019-10-25,Nebraska,3,2,4,9,0.5555555555555556
2019-10-25,Missouri,2,0,2,4,0.75
2019-10-25,Arkansas,18,7,24,49,0.6122448979591837
2019-10-25,Arizona,4,1,2,7,0.7142857142857142
2019-10-25,Pennsylvania,1,1,4,6,0.5
2019-10-25,Colorado,7,3,3,13,0.6538461538461539
2019-10-25,Texas,2,2,5,9,0.5
2019-10-25,Iowa,6,3,0,9,0.6666666666666666
2019-10-25,Michigan,1,3,0,4,0.25
2019-10-25,Mississippi,1,0,0,1,1.0
2019-10-25,Washington,1,0,0,1,1.0
2019-10-25,Delaware,4,0,0,4,1.0
2019-10-25,North Dakota,0,1,0,1,0.0
2019-10-25,Minnesota,2,0,0,2,1.0
2019-10-25,Connecticut,0,0,2,2,0.5
2019-10-25,Maine,0,1,0,1,0.0
2019-10-25,Rhode Island,1,0,0,1,1.0
2019-10-25,Ohio,1,0,0,1,1.0
2019-10-24,Alabama,17,6,11,34,0.6617647058823529
2019-10-24,Colorado,6,5,5,16,0.53125
2019-10-24,New York,8,2,2,12,0.75
2019-10-24,Arkansas,11,6,15,32,0.578125
2019-10-24,Hawaii,17,3,5,25,0.78
2019-10-24,California,31,13,24,68,0.6323529411764706
2019-10-24,Texas,4,1,2,7,0.7142857142857142
2019-10-24,Missouri,8,3,1,12,0.7083333333333333
2019-10-24,Washington,4,0,2,6,0.8333333333333333
2019-10-24,Georgia,3,4,4,11,0.45454545454545453
2019-10-24,Louisiana,9,0,4,13,0.8461538461538461
2019-10-24,New Jersey,1,0,1,2,0.75
2019-10-24,Indiana,12,5,4,21,0.6666666666666666
2019-10-24,Ohio,1,0,0,1,1.0
2019-10-24,Massachusetts,12,4,10,26,0.6538461538461539
2019-10-24,Florida,3,4,4,11,0.45454545454545453
2019-10-24,Idaho,2,0,1,3,0.8333333333333333
2019-10-24,Illinois,5,4,5,14,0.5357142857142857
2019-10-24,Oregon,1,0,0,1,1.0
2019-10-24,Iowa,2,0,3,5,0.7
2019-10-24,Delaware,7,1,4,12,0.75
2019-10-24,Nebraska,3,5,3,11,0.40909090909090906
2019-10-24,Michigan,1,2,1,4,0.375
2019-10-24,Alaska,5,0,4,9,0.7777777777777778
2019-10-24,Arizona,4,0,2,6,0.8333333333333333
2019-10-24,Maine,0,0,1,1,0.5
2019-10-24,Minnesota,1,2,0,3,0.3333333333333333
2019-10-24,South Dakota,0,0,1,1,0.5
2019-10-24,Maryland,1,0,1,2,0.75
2019-10-24,Kansas,1,1,2,4,0.5
2019-10-24,Utah,0,0,1,1,0.5
2019-10-24,Nevada,1,0,0,1,1.0
2019-10-24,Oklahoma,1,0,0,1,1.0
2019-10-24,Pennsylvania,1,0,0,1,1.0
2019-10-24,Mississippi,0,0,1,1,0.5
2019-10-24,West Virginia,0,0,1,1,0.5
2019-10-23,Delaware,5,1,4,10,0.7
2019-10-23,Iowa,6,0,0,6,1.0
2019-10-23,Texas,3,1,4,8,0.625
2019-10-23,Hawaii,18,3,5,26,0.7884615384615384
2019-10-23,Oregon,2,0,2,4,0.75
2019-10-23,Washington,0,0,1,1,0.5
2019-10-23,California,30,9,21,60,0.675
2019-10-23,Illinois,9,5,4,18,0.6111111111111112
2019-10-23,Massachusetts,9,5,5,19,0.6052631578947368
2019-10-23,Florida,4,1,3,8,0.6875
2019-10-23,New Jersey,1,1,1,3,0.5
2019-10-23,Minnesota,2,0,1,3,0.8333333333333333
2019-10-23,Alaska,5,1,4,10,0.7
2019-10-23,Kentucky,0,0,2,2,0.5
2019-10-23,Indiana,11,4,1,16,0.71875
2019-10-23,Maryland,3,1,2,6,0.6666666666666666
2019-10-23,South Carolina,0,0,1,1,0.5
2019-10-23,Arkansas,3,5,11,19,0.4473684210526316
2019-10-23,Alabama,8,5,5,18,0.5833333333333333
2019-10-23,Connecticut,1,0,2,3,0.6666666666666666
2019-10-23,Maine,2,0,0,2,1.0
2019-10-23,Virginia,1,0,1,2,0.75
2019-10-23,Pennsylvania,5,1,1,7,0.7857142857142857
2019-10-23,Colorado,2,3,5,10,0.45
2019-10-23,Idaho,2,1,1,4,0.625
2019-10-23,Louisiana,4,2,2,8,0.625
2019-10-23,New York,4,0,1,5,0.9
2019-10-23,Georgia,2,2,1,5,0.5
2019-10-23,North Carolina,0,0,1,1,0.5
2019-10-23,Arizona,3,0,3,6,0.75
2019-10-23,Nebraska,1,3,2,6,0.3333333333333333
2019-10-23,Mississippi,0,0,1,1,0.5
2019-10-23,Missouri,0,0,1,1,0.5
2019-10-23,Kansas,0,0,2,2,0.5
2019-10-23,Michigan,1,0,0,1,1.0
2019-10-22,Indiana,9,7,12,28,0.5357142857142857
2019-10-22,California,23,11,17,51,0.6176470588235294
2019-10-22,Massachusetts,10,6,3,19,0.6052631578947368
2019-10-22,Alabama,14,8,15,37,0.5810810810810811
2019-10-22,Arkansas,11,7,11,29,0.5689655172413792
2019-10-22,Colorado,9,3,6,18,0.6666666666666666
2019-10-22,Louisiana,2,1,4,7,0.5714285714285714
2019-10-22,Arizona,2,2,1,5,0.5
2019-10-22,Alaska,8,3,7,18,0.6388888888888888
2019-10-22,Texas,4,2,0,6,0.6666666666666666
2019-10-22,Idaho,1,1,0,2,0.5
2019-10-22,Hawaii,13,3,6,22,0.7272727272727273
2019-10-22,Nebraska,2,2,2,6,0.5
2019-10-22,New York,1,0,1,2,0.75
2019-10-22,Florida,4,6,4,14,0.42857142857142855
2019-10-22,Missouri,5,1,5,11,0.6818181818181818
2019-10-22,Georgia,2,1,2,5,0.6000000000000001
2019-10-22,Delaware,8,1,3,12,0.7916666666666666
2019-10-22,Pennsylvania,3,3,0,6,0.5
2019-10-22,Minnesota,1,0,3,4,0.625
2019-10-22,Kansas,0,1,1,2,0.25
2019-10-22,Iowa,4,2,2,8,0.625
2019-10-22,New Hampshire,0,1,0,1,0.0
2019-10-22,Oklahoma,0,1,0,1,0.0
2019-10-22,Washington,0,1,1,2,0.25
2019-10-22,Illinois,5,1,3,9,0.7222222222222222
2019-10-22,Maryland,0,1,0,1,0.0
2019-10-22,Ohio,1,0,1,2,0.75
2019-10-22,Virginia,1,0,0,1,1.0
2019-10-22,Connecticut,0,0,1,1,0.5
2019-10-22,North Dakota,0,0,1,1,0.5
2019-10-22,North Carolina,0,0,1,1,0.5
2019-10-22,Michigan,1,1,0,2,0.5
2019-10-22,New Jersey,0,0,1,1,0.5
2019-10-22,Utah,1,0,0,1,1.0
2019-10-21,Massachusetts,13,4,9,26,0.6730769230769231
2019-10-21,Alaska,7,1,2,10,0.7999999999999999
2019-10-21,California,23,9,16,48,0.6458333333333334
2019-10-21,Louisiana,2,0,2,4,0.75
2019-10-21,Arizona,2,1,4,7,0.5714285714285714
2019-10-21,Idaho,3,0,1,4,0.875
2019-10-21,Alabama,11,7,9,27,0.5740740740740741
2019-10-21,Ohio,1,1,0,2,0.5
2019-10-21,New York,3,2,3,8,0.5625
2019-10-21,Arkansas,13,4,9,26,0.6730769230769231
2019-10-21,Colorado,12,2,2,16,0.8125
2019-10-21,Washington,3,0,0,3,1.0
2019-10-21,Hawaii,6,1,4,11,0.7272727272727273
2019-10-21,Illinois,5,3,4,12,0.5833333333333334
2019-10-21,Nevada,0,1,0,1,0.0
2019-10-21,Florida,2,10,2,14,0.21428571428571427
2019-10-21,Texas,0,2,6,8,0.375
2019-10-21,Iowa,2,1,4,7,0.5714285714285714
2019-10-21,Delaware,6,5,7,18,0.5277777777777778
2019-10-21,Nebraska,5,1,2,8,0.75
2019-10-21,Michigan,0,2,1,3,0.16666666666666666
2019-10-21,Georgia,1,2,2,5,0.4
2019-10-21,Oregon,1,1,2,4,0.5
2019-10-21,Indiana,4,4,4,12,0.5
2019-10-21,Minnesota,1,2,1,4,0.375
2019-10-21,Kentucky,3,1,0,4,0.75
2019-10-21,Pennsylvania,5,0,0,5,1.0
2019-10-21,Oklahoma,0,0,1,1,0.5
2019-10-21,Virginia,0,0,1,1,0.5
2019-10-21,Mississippi,0,0,1,1,0.5
2019-10-21,Connecticut,0,1,0,1,0.0
2019-10-21,Wisconsin,1,0,0,1,1.0
2019-10-21,Rhode Island,1,0,0,1,1.0
2019-10-20,Arkansas,6,8,13,27,0.4629629629629629
2019-10-20,Indiana,4,1,10,15,0.6
2019-10-20,Massachusetts,7,3,5,15,0.6333333333333333
2019-10-20,Arizona,8,5,7,20,0.575
2019-10-20,Texas,5,0,1,6,0.9166666666666667
2019-10-20,Nebraska,4,3,2,9,0.5555555555555556
2019-10-20,Colorado,1,1,4,6,0.5
2019-10-20,Illinois,4,3,2,9,0.5555555555555556
2019-10-20,Alaska,1,1,1,3,0.5
2019-10-20,Iowa,3,5,0,8,0.375
2019-10-20,Louisiana,6,5,1,12,0.5416666666666666
2019-10-20,Alabama,8,5,4,17,0.5882352941176471
2019-10-20,Florida,5,3,4,12,0.5833333333333334
2019-10-20,New Jersey,1,1,1,3,0.5
2019-10-20,Missouri,3,1,1,5,0.7
2019-10-20,California,11,6,10,27,0.5925925925925926
2019-10-20,Delaware,4,1,1,6,0.75
2019-10-20,Georgia,4,1,4,9,0.6666666666666666
2019-10-20,Pennsylvania,2,1,0,3,0.6666666666666666
2019-10-20,Maine,2,0,2,4,0.75
2019-10-20,Hawaii,3,0,4,7,0.7142857142857142
2019-10-20,Kentucky,0,1,0,1,0.0
2019-10-20,Idaho,2,0,1,3,0.8333333333333333
2019-10-20,Connecticut,3,0,0,3,1.0
2019-10-20,Maryland,0,1,2,3,0.3333333333333333
2019-10-20,Oregon,1,0,0,1,1.0
2019-10-20,Minnesota,1,0,1,2,0.75
2019-10-20,Kansas,1,1,0,2,0.5
2019-10-20,Wisconsin,0,1,0,1,0.0
2019-10-20,Washington,2,0,1,3,0.8333333333333333
2019-10-20,Ohio,1,0,0,1,1.0
2019-10-20,New York,2,2,1,5,0.5
2019-10-20,North Carolina,0,1,0,1,0.0
2019-10-19,Georgia,4,5,5,14,0.4642857142857143
2019-10-19,Arkansas,8,9,10,27,0.48148148148148145
2019-10-19,Massachusetts,4,4,8,16,0.5
2019-10-19,Arizona,8,1,5,14,0.75
2019-10-19,Alaska,4,2,0,6,0.6666666666666666
2019-10-19,Oregon,2,3,2,7,0.42857142857142855
2019-10-19,Hawaii,6,3,9,18,0.5833333333333333
2019-10-19,Missouri,3,3,2,8,0.5
2019-10-19,Washington,2,3,3,8,0.4375
2019-10-19,Florida,4,6,1,11,0.4090909090909091
2019-10-19,Iowa,2,0,2,4,0.75
2019-10-19,California,15,12,16,43,0.5348837209302326
2019-10-19,Delaware,3,4,2,9,0.4444444444444444
2019-10-19,New Jersey,0,1,0,1,0.0
2019-10-19,Texas,1,3,4,8,0.375
2019-10-19,New Hampshire,0,0,1,1,0.5
2019-10-19,Kentucky,0,0,2,2,0.5
2019-10-19,Indiana,5,3,4,12,0.5833333333333334
2019-10-19,New York,5,4,4,13,0.5384615384615385
2019-10-19,Louisiana,2,4,1,7,0.3571428571428571
2019-10-19,Connecticut,1,0,2,3,0.6666666666666666
2019-10-19,Pennsylvania,3,0,0,3,1.0
2019-10-19,Illinois,5,0,3,8,0.8125
2019-10-19,Nebraska,1,0,2,3,0.6666666666666666
2019-10-19,Ohio,1,1,0,2,0.5
2019-10-19,Colorado,3,2,1,6,0.5833333333333334
2019-10-19,Alabama,0,10,5,15,0.16666666666666666
2019-10-19,South Carolina,1,0,1,2,0.75
2019-10-19,Maryland,1,1,1,3,0.5
2019-10-19,Idaho,1,1,0,2,0.5
2019-10-19,Michigan,1,2,0,3,0.3333333333333333
2019-10-19,Minnesota,0,0,2,2,0.5
2019-10-19,North Dakota,0,0,1,1,0.5
2019-10-18,Arkansas,13,7,11,31,0.5967741935483871
2019-10-18,Colorado,3,5,6,14,0.42857142857142855
2019-10-18,California,22,9,18,49,0.6326530612244898
2019-10-18,Arizona,6,4,4,14,0.5714285714285714
2019-10-18,Indiana,8,2,10,20,0.65
2019-10-18,Kentucky,1,1,0,2,0.5
2019-10-18,Louisiana,6,3,3,12,0.625
2019-10-18,Florida,4,3,7,14,0.5357142857142857
2019-10-18,Alabama,10,5,5,20,0.625
2019-10-18,Alaska,1,1,2,4,0.5
2019-10-18,New York,1,4,3,8,0.3125
2019-10-18,Ohio,1,0,1,2,0.75
2019-10-18,Pennsylvania,6,0,2,8,0.875
2019-10-18,Nebraska,2,4,3,9,0.38888888888888884
2019-10-18,Delaware,4,4,2,10,0.5
2019-10-18,Hawaii,15,8,7,30,0.6166666666666667
2019-10-18,Massachusetts,16,3,8,27,0.7407407407407407
2019-10-18,Georgia,5,3,0,8,0.625
2019-10-18,Texas,0,1,2,3,0.3333333333333333
2019-10-18,Idaho,1,0,0,1,1.0
2019-10-18,Iowa,1,0,3,4,0.625
2019-10-18,Maryland,0,1,0,1,0.0
2019-10-18,New Jersey,1,0,0,1,1.0
2019-10-18,Missouri,1,0,2,3,0.6666666666666666
2019-10-18,Illinois,1,3,7,11,0.40909090909090906
2019-10-18,Nevada,0,0,1,1,0.5
2019-10-18,Washington,1,1,1,3,0.5
2019-10-18,North Carolina,1,0,0,1,1.0
2019-10-18,Connecticut,0,0,1,1,0.5
2019-10-18,Oregon,0,1,2,3,0.3333333333333333
2019-10-18,Minnesota,1,0,1,2,0.75
2019-10-18,Virginia,0,1,0,1,0.0
2019-10-18,Montana,0,0,1,1,0.5
2019-10-18,Mississippi,1,0,0,1,1.0
2019-10-18,Oklahoma,1,0,0,1,1.0
2019-10-17,Alabama,8,8,11,27,0.5
2019-10-17,Georgia,3,0,3,6,0.75
2019-10-17,Arizona,3,3,7,13,0.5
2019-10-17,Colorado,6,3,2,11,0.6363636363636364
2019-10-17,California,15,6,13,34,0.6323529411764706
2019-10-17,Hawaii,8,4,9,21,0.5952380952380952
2019-10-17,Maryland,0,1,1,2,0.25
2019-10-17,Florida,4,8,6,18,0.38888888888888884
2019-10-17,Arkansas,11,9,6,26,0.5384615384615384
2019-10-17,Louisiana,3,1,3,7,0.6428571428571428
2019-10-17,Pennsylvania,2,2,2,6,0.5
2019-10-17,Massachusetts,12,2,7,21,0.738095238095238
2019-10-17,Alaska,0,0,3,3,0.5
2019-10-17,Nebraska,1,2,4,7,0.42857142857142855
2019-10-17,Oregon,2,2,1,5,0.5
2019-10-17,Illinois,5,3,7,15,0.5666666666666667
2019-10-17,North Carolina,0,1,0,1,0.0
2019-10-17,Texas,4,2,2,8,0.625
2019-10-17,Michigan,0,1,0,1,0.0
2019-10-17,New York,2,6,4,12,0.3333333333333333
2019-10-17,Missouri,3,1,0,4,0.75
2019-10-17,Washington,0,0,3,3,0.5
2019-10-17,Virginia,1,0,0,1,1.0
2019-10-17,Tennessee,1,0,0,1,1.0
2019-10-17,Indiana,5,0,10,15,0.6666666666666666
2019-10-17,Mississippi,0,1,0,1,0.0
2019-10-17,Kentucky,0,0,2,2,0.5
2019-10-17,Delaware,3,3,2,8,0.5
2019-10-17,Minnesota,1,0,0,1,1.0
2019-10-17,Maine,1,0,2,3,0.6666666666666666
2019-10-17,New Jersey,1,1,0,2,0.5
2019-10-17,Iowa,5,1,1,7,0.7857142857142857
2019-10-17,Idaho,1,0,1,2,0.75
2019-10-17,New Hampshire,1,0,0,1,1.0
2019-10-17,Kansas,0,1,0,1,0.0
2019-10-17,South Carolina,0,0,1,1,0.5
2019-10-16,Michigan,2,0,2,4,0.75
2019-10-16,Alabama,9,8,10,27,0.5185185185185185
2019-10-16,California,18,13,27,58,0.5431034482758621
2019-10-16,Arizona,6,1,8,15,0.6666666666666667
2019-10-16,New York,5,3,6,14,0.5714285714285714
2019-10-16,Arkansas,7,7,7,21,0.5
2019-10-16,Hawaii,14,7,14,35,0.6000000000000001
2019-10-16,Georgia,1,5,2,8,0.25
2019-10-16,Massachusetts,10,6,7,23,0.5869565217391304
2019-10-16,New Jersey,2,0,1,3,0.8333333333333333
2019-10-16,Indiana,6,2,11,19,0.6052631578947368
2019-10-16,Illinois,3,4,3,10,0.44999999999999996
2019-10-16,Delaware,4,1,7,12,0.625
2019-10-16,Florida,8,3,9,20,0.625
2019-10-16,Missouri,3,1,1,5,0.7
2019-10-16,Kentucky,1,0,2,3,0.6666666666666666
2019-10-16,Colorado,4,1,7,12,0.625
2019-10-16,Louisiana,11,1,5,17,0.7941176470588236
2019-10-16,Iowa,4,1,3,8,0.6875
2019-10-16,Nebraska,2,1,1,4,0.625
2019-10-16,Texas,2,1,4,7,0.5714285714285714
2019-10-16,Pennsylvania,3,0,1,4,0.875
2019-10-16,Oregon,2,1,1,4,0.625
2019-10-16,Alaska,2,2,7,11,0.5
2019-10-16,Connecticut,2,0,0,2,1.0
2019-10-16,Idaho,2,1,3,6,0.5833333333333333
2019-10-16,Ohio,0,0,2,2,0.5
2019-10-16,New Hampshire,0,1,0,1,0.0
2019-10-16,Minnesota,1,1,0,2,0.5
2019-10-16,Washington,1,1,2,4,0.5
2019-10-16,Kansas,0,0,3,3,0.5
2019-10-16,Oklahoma,1,0,0,1,1.0
2019-10-16,New Mexico,0,1,0,1,0.0
2019-10-16,Montana,0,0,1,1,0.5
2019-10-16,North Carolina,1,0,1,2,0.75
2019-10-16,Rhode Island,1,0,0,1,1.0
2019-10-15,Alabama,12,4,14,30,0.6333333333333333
2019-10-15,New York,5,5,5,15,0.5
2019-10-15,Delaware,5,5,8,18,0.5
2019-10-15,California,25,16,38,79,0.5569620253164558
2019-10-15,Florida,9,1,7,17,0.7352941176470589
2019-10-15,Nevada,0,1,0,1,0.0
2019-10-15,Hawaii,14,4,9,27,0.6851851851851851
2019-10-15,Kansas,1,2,1,4,0.375
2019-10-15,Colorado,10,2,7,19,0.7105263157894737
2019-10-15,Georgia,6,3,4,13,0.6153846153846154
2019-10-15,New Hampshire,2,1,2,5,0.6000000000000001
2019-10-15,Texas,2,2,8,12,0.5
2019-10-15,Minnesota,2,0,5,7,0.6428571428571428
2019-10-15,Iowa,4,3,5,12,0.5416666666666666
2019-10-15,Arkansas,13,6,11,30,0.6166666666666667
2019-10-15,New Jersey,0,1,3,4,0.375
2019-10-15,Oregon,0,1,1,2,0.25
2019-10-15,Massachusetts,14,6,18,38,0.6052631578947368
2019-10-15,Arizona,3,3,5,11,0.5
2019-10-15,Illinois,12,6,13,31,0.5967741935483871
2019-10-15,Indiana,9,7,16,32,0.53125
2019-10-15,Nebraska,6,1,3,10,0.75
2019-10-15,Alaska,6,4,4,14,0.5714285714285714
2019-10-15,South Carolina,0,1,0,1,0.0
2019-10-15,Washington,4,2,5,11,0.5909090909090909
2019-10-15,Louisiana,5,2,3,10,0.65
2019-10-15,Maryland,1,0,2,3,0.6666666666666666
2019-10-15,Pennsylvania,4,1,2,7,0.7142857142857142
2019-10-15,Michigan,1,0,2,3,0.6666666666666666
2019-10-15,Connecticut,1,1,4,6,0.5
2019-10-15,Missouri,0,2,2,4,0.25
2019-10-15,Maine,0,1,0,1,0.0
2019-10-15,Kentucky,1,0,0,1,1.0
2019-10-15,South Dakota,0,0,1,1,0.5
2019-10-15,Idaho,0,1,1,2,0.25
2019-10-15,North Dakota,1,0,0,1,1.0
2019-10-15,Tennessee,0,0,1,1,0.5
2019-10-15,West Virginia,0,0,1,1,0.5
2019-10-14,Hawaii,5,3,6,14,0.5714285714285714
2019-10-14,Alabama,5,6,7,18,0.4722222222222222
2019-10-14,Indiana,5,10,7,22,0.38636363636363635
2019-10-14,California,19,9,4,32,0.65625
2019-10-14,Arkansas,6,5,8,19,0.5263157894736842
2019-10-14,New York,4,2,2,8,0.625
2019-10-14,Massachusetts,5,2,3,10,0.65
2019-10-14,Alaska,5,2,2,9,0.6666666666666667
2019-10-14,Missouri,2,0,0,2,1.0
2019-10-14,Delaware,2,1,3,6,0.5833333333333333
2019-10-14,Texas,1,0,6,7,0.5714285714285714
2019-10-14,Colorado,6,4,3,13,0.576923076923077
2019-10-14,Oregon,2,1,4,7,0.5714285714285714
2019-10-14,Florida,9,7,7,23,0.5434782608695652
2019-10-14,Georgia,4,1,4,9,0.6666666666666666
2019-10-14,Louisiana,1,4,3,8,0.3125
2019-10-14,Kansas,0,2,1,3,0.16666666666666666
2019-10-14,Illinois,2,2,11,15,0.5
2019-10-14,Arizona,3,2,6,11,0.5454545454545454
2019-10-14,Michigan,2,1,1,4,0.625
2019-10-14,Pennsylvania,2,0,2,4,0.75
2019-10-14,Idaho,0,0,2,2,0.5
2019-10-14,Ohio,1,0,1,2,0.75
2019-10-14,Nebraska,1,1,2,4,0.5
2019-10-14,Minnesota,2,0,0,2,1.0
2019-10-14,Connecticut,1,0,2,3,0.6666666666666666
2019-10-14,Iowa,1,0,2,3,0.6666666666666666
2019-10-14,Oklahoma,1,0,0,1,1.0
2019-10-14,Washington,2,0,0,2,1.0
2019-10-14,Virginia,2,0,0,2,1.0
2019-10-14,Maryland,1,0,1,2,0.75
2019-10-13,Colorado,2,2,4,8,0.5
2019-10-13,Alaska,3,0,3,6,0.75
2019-10-13,Alabama,3,12,4,19,0.2631578947368421
2019-10-13,Hawaii,8,2,5,15,0.7
2019-10-13,Arizona,2,5,1,8,0.3125
2019-10-13,Georgia,1,3,4,8,0.375
2019-10-13,California,10,7,13,30,0.55
2019-10-13,Washington,0,1,1,2,0.25
2019-10-13,Ohio,0,0,1,1,0.5
2019-10-13,Florida,6,6,6,18,0.5
2019-10-13,Idaho,0,0,3,3,0.5
2019-10-13,Illinois,2,2,4,8,0.5
2019-10-13,Arkansas,8,6,14,28,0.5357142857142857
2019-10-13,Nebraska,3,1,1,5,0.7
2019-10-13,Indiana,10,3,4,17,0.7058823529411765
2019-10-13,Maryland,1,1,0,2,0.5
2019-10-13,Texas,4,3,0,7,0.5714285714285714
2019-10-13,Louisiana,1,1,2,4,0.5
2019-10-13,Virginia,0,0,1,1,0.5
2019-10-13,Missouri,0,0,3,3,0.5
2019-10-13,South Carolina,0,1,0,1,0.0
2019-10-13,Massachusetts,6,3,7,16,0.59375
2019-10-13,Iowa,1,2,1,4,0.375
2019-10-13,New Jersey,0,1,1,2,0.25
2019-10-13,Kentucky,0,0,1,1,0.5
2019-10-13,North Carolina,0,1,0,1,0.0
2019-10-13,Minnesota,1,1,0,2,0.5
2019-10-13,Oregon,1,1,1,3,0.5
2019-10-13,Michigan,3,0,0,3,1.0
2019-10-13,Delaware,0,1,3,4,0.375
2019-10-13,Kansas,1,1,0,2,0.5
2019-10-13,New York,3,0,3,6,0.75
2019-10-13,Maine,2,0,0,2,1.0
2019-10-13,New Hampshire,1,0,0,1,1.0
2019-10-13,North Dakota,1,0,0,1,1.0
2019-10-12,Idaho,2,0,2,4,0.75
2019-10-12,Indiana,8,12,9,29,0.43103448275862066
2019-10-12,Illinois,6,2,5,13,0.6538461538461539
2019-10-12,Massachusetts,7,4,2,13,0.6153846153846154
2019-10-12,New York,3,1,2,6,0.6666666666666666
2019-10-12,California,14,10,13,37,0.5540540540540541
2019-10-12,Colorado,11,0,6,17,0.823529411764706
2019-10-12,Alabama,13,12,12,37,0.5135135135135136
2019-10-12,Florida,7,5,5,17,0.5588235294117647
2019-10-12,Nebraska,4,5,5,14,0.4642857142857143
2019-10-12,Arizona,2,2,3,7,0.5
2019-10-12,Iowa,1,1,3,5,0.5
2019-10-12,Arkansas,7,9,14,30,0.4666666666666667
2019-10-12,Georgia,3,2,0,5,0.6
2019-10-12,Louisiana,5,2,3,10,0.65
2019-10-12,New Jersey,0,2,0,2,0.0
2019-10-12,Delaware,3,0,2,5,0.8
2019-10-12,Michigan,4,0,1,5,0.9
2019-10-12,Texas,2,2,3,7,0.5
2019-10-12,Oregon,2,1,1,4,0.625
2019-10-12,Alaska,1,2,2,5,0.4
2019-10-12,Hawaii,3,4,4,11,0.45454545454545453
2019-10-12,Minnesota,1,0,0,1,1.0
2019-10-12,Missouri,2,0,0,2,1.0
2019-10-12,Pennsylvania,3,0,4,7,0.7142857142857142
2019-10-12,Washington,0,0,1,1,0.5
2019-10-12,Maryland,1,1,0,2,0.5
2019-10-12,Virginia,0,1,0,1,0.0
2019-10-12,Ohio,1,0,1,2,0.75
2019-10-12,Connecticut,0,1,0,1,0.0
2019-10-12,Kansas,0,1,1,2,0.25
2019-10-11,Illinois,7,2,11,20,0.625
2019-10-11,Oregon,2,5,4,11,0.36363636363636365
2019-10-11,Alabama,17,9,19,45,0.5888888888888889
2019-10-11,Massachusetts,20,5,4,29,0.7586206896551725
2019-10-11,Colorado,26,11,9,46,0.6630434782608695
2019-10-11,Delaware,7,1,4,12,0.75
2019-10-11,California,31,10,25,66,0.6590909090909092
2019-10-11,New York,10,2,3,15,0.7666666666666666
2019-10-11,Alaska,2,1,6,9,0.5555555555555556
2019-10-11,Indiana,15,13,8,36,0.5277777777777778
2019-10-11,Georgia,6,1,2,9,0.7777777777777777
2019-10-11,Hawaii,22,2,7,31,0.8225806451612904
2019-10-11,Arkansas,13,7,17,37,0.5810810810810811
2019-10-11,Michigan,3,3,3,9,0.5
2019-10-11,Florida,6,6,6,18,0.5
2019-10-11,Louisiana,4,4,4,12,0.5
2019-10-11,Arizona,3,3,3,9,0.5
2019-10-11,Idaho,0,1,2,3,0.3333333333333333
2019-10-11,Iowa,4,1,1,6,0.75
2019-10-11,Nebraska,3,2,0,5,0.6
2019-10-11,Pennsylvania,2,2,2,6,0.5
2019-10-11,Missouri,3,1,2,6,0.6666666666666666
2019-10-11,Utah,0,0,1,1,0.5
2019-10-11,Texas,2,1,8,11,0.5454545454545454
2019-10-11,Washington,0,1,1,2,0.25
2019-10-11,North Dakota,0,1,0,1,0.0
2019-10-11,Ohio,1,0,1,2,0.75
2019-10-11,Minnesota,0,1,0,1,0.0
2019-10-11,Kansas,0,1,1,2,0.25
2019-10-11,Nevada,1,0,0,1,1.0
2019-10-11,Oklahoma,1,0,1,2,0.75
2019-10-11,Maine,0,1,0,1,0.0
2019-10-11,Wisconsin,0,0,1,1,0.5
2019-10-11,New Jersey,1,1,1,3,0.5
2019-10-11,Kentucky,0,1,0,1,0.0
2019-10-11,Tennessee,1,0,0,1,1.0
2019-10-11,Maryland,1,1,0,2,0.5
2019-10-11,South Dakota,0,0,1,1,0.5
2019-10-10,Texas,3,2,4,9,0.5555555555555556
2019-10-10,Indiana,8,3,3,14,0.6785714285714285
2019-10-10,Colorado,12,3,10,25,0.6799999999999999
2019-10-10,California,18,9,20,47,0.5957446808510638
2019-10-10,Oregon,1,1,1,3,0.5
2019-10-10,Arkansas,10,10,10,30,0.5
2019-10-10,Nebraska,1,1,1,3,0.5
2019-10-10,Louisiana,2,0,2,4,0.75
2019-10-10,Massachusetts,3,11,7,21,0.30952380952380953
2019-10-10,Arizona,5,2,4,11,0.6363636363636364
2019-10-10,Alaska,4,0,1,5,0.9
2019-10-10,New York,10,6,6,22,0.5909090909090908
2019-10-10,Georgia,4,6,4,14,0.42857142857142855
2019-10-10,Kansas,1,1,2,4,0.5
2019-10-10,Hawaii,16,5,4,25,0.72
2019-10-10,Alabama,7,6,6,19,0.5263157894736842
2019-10-10,New Jersey,0,0,1,1,0.5
2019-10-10,Florida,7,6,3,16,0.53125
2019-10-10,Utah,0,0,1,1,0.5
2019-10-10,Pennsylvania,3,1,4,8,0.625
2019-10-10,Missouri,3,2,2,7,0.5714285714285714
2019-10-10,South Carolina,1,0,0,1,1.0
2019-10-10,Illinois,5,1,5,11,0.6818181818181818
2019-10-10,Kentucky,0,0,1,1,0.5
2019-10-10,Connecticut,1,0,1,2,0.75
2019-10-10,Iowa,0,0,1,1,0.5
2019-10-10,Maine,0,1,0,1,0.0
2019-10-10,Washington,2,0,2,4,0.75
2019-10-10,Ohio,1,0,2,3,0.6666666666666666
2019-10-10,Delaware,1,1,2,4,0.5
2019-10-10,Minnesota,0,0,2,2,0.5
2019-10-10,Maryland,0,0,1,1,0.5
2019-10-10,Wisconsin,0,1,0,1,0.0
2019-10-10,New Hampshire,1,0,1,2,0.75
2019-10-10,Michigan,0,1,0,1,0.0
2019-10-10,New Mexico,1,0,0,1,1.0
2019-10-09,Alaska,4,4,10,18,0.5
2019-10-09,Arizona,2,1,5,8,0.5625
2019-10-09,Nebraska,0,1,5,6,0.4166666666666667
2019-10-09,California,20,12,26,58,0.5689655172413793
2019-10-09,Colorado,8,4,10,22,0.5909090909090909
2019-10-09,Florida,7,9,7,23,0.4565217391304348
2019-10-09,Georgia,2,0,6,8,0.625
2019-10-09,Arkansas,11,4,8,23,0.6521739130434783
2019-10-09,Alabama,6,8,14,28,0.4642857142857143
2019-10-09,Hawaii,9,1,6,16,0.75
2019-10-09,Illinois,3,2,6,11,0.5454545454545454
2019-10-09,Louisiana,5,3,4,12,0.5833333333333334
2019-10-09,New York,4,1,4,9,0.6666666666666666
2019-10-09,Massachusetts,7,9,10,26,0.46153846153846156
2019-10-09,Minnesota,0,0,1,1,0.5
2019-10-09,Indiana,2,3,8,13,0.46153846153846156
2019-10-09,Delaware,4,0,2,6,0.8333333333333333
2019-10-09,Oregon,1,0,4,5,0.6000000000000001
2019-10-09,Iowa,1,3,3,7,0.3571428571428571
2019-10-09,Michigan,0,1,2,3,0.3333333333333333
2019-10-09,Missouri,1,2,4,7,0.42857142857142855
2019-10-09,Texas,2,3,2,7,0.42857142857142855
2019-10-09,Montana,1,1,0,2,0.5
2019-10-09,Pennsylvania,9,1,3,13,0.8076923076923077
2019-10-09,New Jersey,0,1,1,2,0.25
2019-10-09,Washington,1,1,2,4,0.5
2019-10-09,Connecticut,0,2,1,3,0.16666666666666666
2019-10-09,Idaho,0,0,1,1,0.5
2019-10-09,Maine,1,0,0,1,1.0
2019-10-09,Nevada,0,0,1,1,0.5
2019-10-09,Kentucky,0,0,1,1,0.5
2019-10-08,North Carolina,0,1,1,2,0.25
2019-10-08,California,17,10,19,46,0.5760869565217391
2019-10-08,Alaska,1,1,4,6,0.5
2019-10-08,Kentucky,1,0,0,1,1.0
2019-10-08,Alabama,11,5,7,23,0.6304347826086957
2019-10-08,Arkansas,8,4,12,24,0.5833333333333333
2019-10-08,Idaho,0,0,3,3,0.5
2019-10-08,Indiana,8,3,10,21,0.6190476190476191
2019-10-08,Georgia,3,2,3,8,0.5625
2019-10-08,Connecticut,3,1,3,7,0.6428571428571428
2019-10-08,Delaware,4,2,6,12,0.5833333333333333
2019-10-08,Illinois,1,1,3,5,0.5
2019-10-08,Iowa,2,2,3,7,0.5
2019-10-08,Nebraska,3,1,4,8,0.625
2019-10-08,Kansas,1,0,0,1,1.0
2019-10-08,Massachusetts,8,3,5,16,0.65625
2019-10-08,Florida,6,2,9,17,0.6176470588235294
2019-10-08,Colorado,4,5,5,14,0.4642857142857143
2019-10-08,Utah,0,0,2,2,0.5
2019-10-08,Arizona,5,2,1,8,0.6875
2019-10-08,Missouri,0,1,4,5,0.4
2019-10-08,Michigan,1,1,1,3,0.5
2019-10-08,Oregon,2,1,4,7,0.5714285714285714
2019-10-08,Texas,4,3,3,10,0.55
2019-10-08,Hawaii,14,4,2,20,0.75
2019-10-08,Louisiana,3,1,4,8,0.625
2019-10-08,Minnesota,1,0,2,3,0.6666666666666666
2019-10-08,New York,2,3,5,10,0.45
2019-10-08,Ohio,0,0,1,1,0.5
2019-10-08,Maryland,2,0,0,2,1.0
2019-10-08,Washington,3,0,0,3,1.0
2019-10-08,Rhode Island,0,1,0,1,0.0
2019-10-08,New Mexico,1,0,0,1,1.0
2019-10-08,Pennsylvania,0,0,1,1,0.5
2019-10-08,New Jersey,0,0,1,1,0.5
2019-10-07,Missouri,2,0,1,3,0.8333333333333333
2019-10-07,Alabama,15,6,8,29,0.6551724137931034
2019-10-07,Iowa,10,0,2,12,0.9166666666666667
2019-10-07,Indiana,8,22,10,40,0.325
2019-10-07,Hawaii,11,2,4,17,0.7647058823529412
2019-10-07,Arkansas,10,9,6,25,0.52
2019-10-07,California,24,7,11,42,0.7023809523809523
2019-10-07,Arizona,3,2,5,10,0.55
2019-10-07,Massachusetts,11,11,13,35,0.5
2019-10-07,Ohio,1,0,0,1,1.0
2019-10-07,New Jersey,1,1,1,3,0.5
2019-10-07,Alaska,2,1,3,6,0.5833333333333333
2019-10-07,New Hampshire,0,1,1,2,0.25
2019-10-07,Colorado,4,1,4,9,0.6666666666666666
2019-10-07,Texas,4,3,1,8,0.5625
2019-10-07,Georgia,1,2,5,8,0.4375
2019-10-07,Illinois,8,3,4,15,0.6666666666666666
2019-10-07,Florida,5,6,4,15,0.4666666666666667
2019-10-07,Louisiana,3,1,1,5,0.7
2019-10-07,Washington,2,1,0,3,0.6666666666666666
2019-10-07,Oregon,1,0,1,2,0.75
2019-10-07,Idaho,3,0,1,4,0.875
2019-10-07,Mississippi,1,0,0,1,1.0
2019-10-07,Kentucky,3,0,0,3,1.0
2019-10-07,Pennsylvania,2,3,2,7,0.42857142857142855
2019-10-07,Delaware,1,0,6,7,0.5714285714285714
2019-10-07,Minnesota,0,0,2,2,0.5
2019-10-07,Connecticut,1,1,0,2,0.5
2019-10-07,New York,1,1,2,4,0.5
2019-10-07,Kansas,0,0,1,1,0.5
2019-10-07,Nebraska,2,0,3,5,0.7
2019-10-07,Michigan,0,0,1,1,0.5
2019-10-07,Maryland,1,0,1,2,0.75
2019-10-06,Alabama,8,2,6,16,0.6875
2019-10-06,California,13,9,14,36,0.5555555555555556
2019-10-06,Indiana,6,3,4,13,0.6153846153846154
2019-10-06,Illinois,6,4,4,14,0.5714285714285714
2019-10-06,Arkansas,7,6,6,19,0.5263157894736842
2019-10-06,Georgia,0,2,2,4,0.25
2019-10-06,Florida,1,4,0,5,0.2
2019-10-06,Massachusetts,6,1,9,16,0.65625
2019-10-06,Alaska,2,4,4,10,0.4
2019-10-06,Texas,1,1,3,5,0.5
2019-10-06,Hawaii,6,3,5,14,0.6071428571428571
2019-10-06,Idaho,1,2,1,4,0.375
2019-10-06,Washington,2,2,3,7,0.5
2019-10-06,Nebraska,1,2,2,5,0.4
2019-10-06,New York,4,0,3,7,0.7857142857142857
2019-10-06,Delaware,2,0,1,3,0.8333333333333333
2019-10-06,Iowa,5,2,2,9,0.6666666666666667
2019-10-06,North Dakota,1,1,1,3,0.5
2019-10-06,New Jersey,1,0,1,2,0.75
2019-10-06,Colorado,1,3,3,7,0.3571428571428571
2019-10-06,Louisiana,2,2,3,7,0.5
2019-10-06,Kansas,1,0,0,1,1.0
2019-10-06,Pennsylvania,2,1,3,6,0.5833333333333333
2019-10-06,Arizona,2,3,3,8,0.4375
2019-10-06,Kentucky,0,2,1,3,0.16666666666666666
2019-10-06,Wisconsin,0,1,0,1,0.0
2019-10-06,Oklahoma,0,3,0,3,0.0
2019-10-06,Maryland,1,0,0,1,1.0
2019-10-06,Oregon,2,0,0,2,1.0
2019-10-06,Missouri,1,1,2,4,0.5
2019-10-06,Connecticut,0,0,1,1,0.5
2019-10-06,Rhode Island,1,0,0,1,1.0
2019-10-06,North Carolina,0,0,1,1,0.5
2019-10-06,Michigan,0,1,0,1,0.0
2019-10-05,Alabama,9,4,6,19,0.631578947368421
2019-10-05,Indiana,4,5,9,18,0.4722222222222222
2019-10-05,Illinois,1,3,2,6,0.3333333333333333
2019-10-05,California,19,9,13,41,0.6219512195121951
2019-10-05,Pennsylvania,2,1,1,4,0.625
2019-10-05,Arkansas,7,10,8,25,0.44000000000000006
2019-10-05,Massachusetts,10,0,4,14,0.8571428571428572
2019-10-05,Colorado,6,2,1,9,0.7222222222222222
2019-10-05,Florida,4,3,3,10,0.55
2019-10-05,Georgia,6,7,12,25,0.48
2019-10-05,Nebraska,4,1,2,7,0.7142857142857142
2019-10-05,New Jersey,1,1,3,5,0.5
2019-10-05,Texas,2,1,4,7,0.5714285714285714
2019-10-05,New York,2,1,3,6,0.5833333333333333
2019-10-05,Minnesota,2,0,1,3,0.8333333333333333
2019-10-05,Connecticut,0,3,2,5,0.2
2019-10-05,Missouri,2,2,1,5,0.5
2019-10-05,Hawaii,4,3,3,10,0.55
2019-10-05,Michigan,0,1,1,2,0.25
2019-10-05,Oregon,0,0,2,2,0.5
2019-10-05,North Carolina,0,0,1,1,0.5
2019-10-05,Utah,0,1,0,1,0.0
2019-10-05,Maine,0,1,0,1,0.0
2019-10-05,Iowa,3,2,2,7,0.5714285714285714
2019-10-05,Idaho,2,1,0,3,0.6666666666666666
2019-10-05,Washington,0,2,0,2,0.0
2019-10-05,Ohio,2,0,0,2,1.0
2019-10-05,Delaware,1,2,3,6,0.41666666666666663
2019-10-05,Arizona,2,0,2,4,0.75
2019-10-05,Alaska,2,3,2,7,0.42857142857142855
2019-10-05,Louisiana,1,1,1,3,0.5
2019-10-05,Nevada,1,0,0,1,1.0
2019-10-05,Oklahoma,0,0,1,1,0.5
2019-10-05,Kansas,0,2,1,3,0.16666666666666666
2019-10-05,Maryland,1,0,0,1,1.0
2019-10-04,Kansas,2,3,1,6,0.41666666666666663
2019-10-04,Louisiana,6,2,3,11,0.6818181818181818
2019-10-04,Indiana,6,8,17,31,0.46774193548387094
2019-10-04,Delaware,5,7,7,19,0.4473684210526315
2019-10-04,Hawaii,7,7,7,21,0.5
2019-10-04,Alaska,2,0,4,6,0.6666666666666666
2019-10-04,Arkansas,15,14,24,53,0.5094339622641509
2019-10-04,California,20,15,20,55,0.5454545454545454
2019-10-04,Oregon,3,4,2,9,0.4444444444444444
2019-10-04,Colorado,9,4,13,26,0.5961538461538461
2019-10-04,Alabama,11,10,19,40,0.5125
2019-10-04,Illinois,4,5,7,16,0.46875
2019-10-04,Nebraska,4,4,6,14,0.5
2019-10-04,Arizona,8,4,5,17,0.6176470588235294
2019-10-04,Florida,12,5,5,22,0.6590909090909091
2019-10-04,Iowa,16,14,18,48,0.5208333333333333
2019-10-04,Missouri,2,0,3,5,0.7
2019-10-04,Maryland,1,0,2,3,0.6666666666666666
2019-10-04,Georgia,9,2,10,21,0.6666666666666666
2019-10-04,New Jersey,3,1,0,4,0.75
2019-10-04,Pennsylvania,0,4,5,9,0.2777777777777778
2019-10-04,Texas,8,0,9,17,0.7352941176470589
2019-10-04,Minnesota,2,2,2,6,0.5
2019-10-04,Massachusetts,9,3,9,21,0.6428571428571428
2019-10-04,Washington,2,1,4,7,0.5714285714285714
2019-10-04,New York,7,0,3,10,0.85
2019-10-04,Michigan,1,1,2,4,0.5
2019-10-04,Kentucky,0,1,1,2,0.25
2019-10-04,South Carolina,0,1,0,1,0.0
2019-10-04,Connecticut,1,0,3,4,0.625
2019-10-04,North Carolina,1,2,1,4,0.375
2019-10-04,Idaho,0,1,2,3,0.3333333333333333
2019-10-04,Virginia,2,1,1,4,0.625
2019-10-04,Maine,0,0,1,1,0.5
2019-10-04,Ohio,0,1,0,1,0.0
2019-10-04,Nevada,0,0,1,1,0.5
2019-10-03,California,30,11,34,75,0.6266666666666667
2019-10-03,Delaware,4,0,8,12,0.6666666666666666
2019-10-03,Florida,8,11,10,29,0.4482758620689655
2019-10-03,Indiana,19,10,23,52,0.5865384615384615
2019-10-03,Missouri,2,0,4,6,0.6666666666666666
2019-10-03,Georgia,6,9,13,28,0.4464285714285714
2019-10-03,Arkansas,12,9,27,48,0.53125
2019-10-03,Minnesota,3,1,1,5,0.7
2019-10-03,Iowa,3,3,3,9,0.5
2019-10-03,Louisiana,8,3,3,14,0.6785714285714285
2019-10-03,Alabama,15,13,11,39,0.5256410256410257
2019-10-03,Hawaii,13,7,9,29,0.603448275862069
2019-10-03,Texas,6,7,6,19,0.47368421052631576
2019-10-03,Illinois,7,4,6,17,0.5882352941176471
2019-10-03,New York,8,5,5,18,0.5833333333333333
2019-10-03,Massachusetts,12,2,12,26,0.6923076923076923
2019-10-03,New Jersey,1,1,1,3,0.5
2019-10-03,North Dakota,1,1,0,2,0.5
2019-10-03,Colorado,10,3,7,20,0.675
2019-10-03,North Carolina,1,1,2,4,0.5
2019-10-03,Kentucky,1,0,2,3,0.6666666666666666
2019-10-03,Virginia,2,1,1,4,0.625
2019-10-03,Pennsylvania,1,2,4,7,0.42857142857142855
2019-10-03,Arizona,5,2,3,10,0.65
2019-10-03,Alaska,3,4,8,15,0.4666666666666667
2019-10-03,Oklahoma,1,0,2,3,0.6666666666666666
2019-10-03,Nebraska,6,3,6,15,0.6000000000000001
2019-10-03,Ohio,0,0,2,2,0.5
2019-10-03,Washington,2,1,3,6,0.5833333333333333
2019-10-03,Maine,1,0,0,1,1.0
2019-10-03,Wisconsin,2,0,0,2,1.0
2019-10-03,Michigan,4,1,1,6,0.75
2019-10-03,Kansas,1,0,1,2,0.75
2019-10-03,Mississippi,2,3,0,5,0.4
2019-10-03,Connecticut,0,0,1,1,0.5
2019-10-03,Oregon,0,1,3,4,0.375
2019-10-03,Utah,0,1,0,1,0.0
2019-10-03,Nevada,1,0,0,1,1.0
2019-10-03,Idaho,0,1,1,2,0.25
2019-10-03,Maryland,1,1,0,2,0.5
2019-10-02,California,29,4,29,62,0.7016129032258064
2019-10-02,Missouri,0,1,4,5,0.4
2019-10-02,Alaska,2,4,2,8,0.375
2019-10-02,Georgia,8,5,11,24,0.5625
2019-10-02,Arkansas,19,13,24,56,0.5535714285714286
2019-10-02,Arizona,3,1,3,7,0.6428571428571428
2019-10-02,Indiana,9,6,16,31,0.5483870967741935
2019-10-02,Washington,2,0,3,5,0.7
2019-10-02,Massachusetts,11,8,20,39,0.5384615384615384
2019-10-02,New York,4,5,14,23,0.4782608695652174
2019-10-02,Nebraska,5,1,6,12,0.6666666666666667
2019-10-02,Pennsylvania,3,0,5,8,0.6875
2019-10-02,Texas,6,5,5,16,0.53125
2019-10-02,Kentucky,0,2,7,9,0.3888888888888889
2019-10-02,Wisconsin,1,0,1,2,0.75
2019-10-02,Oregon,1,3,4,8,0.375
2019-10-02,Iowa,6,2,4,12,0.6666666666666666
2019-10-02,Alabama,20,12,13,45,0.5888888888888888
2019-10-02,Colorado,7,3,10,20,0.6
2019-10-02,Hawaii,17,3,22,42,0.6666666666666667
2019-10-02,Florida,9,5,8,22,0.5909090909090909
2019-10-02,Illinois,14,11,9,34,0.5441176470588235
2019-10-02,Minnesota,5,0,1,6,0.9166666666666667
2019-10-02,New Mexico,0,0,1,1,0.5
2019-10-02,Utah,0,0,1,1,0.5
2019-10-02,Louisiana,5,5,7,17,0.5
2019-10-02,Idaho,1,1,1,3,0.5
2019-10-02,Kansas,0,0,4,4,0.5
2019-10-02,Maryland,5,1,2,8,0.75
2019-10-02,New Jersey,2,3,2,7,0.42857142857142855
2019-10-02,Delaware,6,3,4,13,0.6153846153846154
2019-10-02,Connecticut,1,1,2,4,0.5
2019-10-02,Ohio,0,0,2,2,0.5
2019-10-02,North Carolina,2,0,0,2,1.0
2019-10-02,North Dakota,0,1,1,2,0.25
2019-10-02,Rhode Island,0,0,1,1,0.5
2019-10-02,Tennessee,0,1,0,1,0.0
2019-10-02,Michigan,1,2,2,5,0.4
2019-10-02,Virginia,0,1,0,1,0.0
2019-10-01,Florida,10,9,10,29,0.5172413793103449
2019-10-01,California,26,7,24,57,0.6666666666666666
2019-10-01,Alabama,12,4,18,34,0.6176470588235294
2019-10-01,Colorado,10,1,13,24,0.6875
2019-10-01,Georgia,12,4,10,26,0.6538461538461539
2019-10-01,Massachusetts,15,3,6,24,0.75
2019-10-01,Arkansas,22,16,12,50,0.56
2019-10-01,Arizona,7,1,1,9,0.8333333333333334
2019-10-01,Alaska,7,2,1,10,0.75
2019-10-01,Indiana,14,8,14,36,0.5833333333333334
2019-10-01,Washington,7,2,6,15,0.6666666666666667
2019-10-01,Delaware,5,6,4,15,0.4666666666666667
2019-10-01,New York,7,6,10,23,0.5217391304347826
2019-10-01,Minnesota,3,0,4,7,0.7142857142857142
2019-10-01,Virginia,1,0,1,2,0.75
2019-10-01,Idaho,0,3,2,5,0.2
2019-10-01,Pennsylvania,7,0,2,9,0.8888888888888888
2019-10-01,Kentucky,2,3,0,5,0.4
2019-10-01,Hawaii,10,4,15,29,0.603448275862069
2019-10-01,Texas,6,7,8,21,0.47619047619047616
2019-10-01,Ohio,3,2,8,13,0.5384615384615385
2019-10-01,New Jersey,2,2,0,4,0.5
2019-10-01,Missouri,5,0,1,6,0.9166666666666667
2019-10-01,Nebraska,2,4,9,15,0.43333333333333335
2019-10-01,Maine,0,0,2,2,0.5
2019-10-01,Illinois,2,8,9,19,0.3421052631578947
2019-10-01,Iowa,1,1,9,11,0.5
2019-10-01,Connecticut,1,0,2,3,0.6666666666666666
2019-10-01,North Carolina,0,1,1,2,0.25
2019-10-01,Louisiana,7,0,8,15,0.7333333333333334
2019-10-01,New Mexico,1,0,1,2,0.75
2019-10-01,Michigan,5,2,2,9,0.6666666666666667
2019-10-01,Kansas,1,1,2,4,0.5
2019-10-01,Oregon,1,2,4,7,0.42857142857142855
2019-10-01,Montana,0,0,1,1,0.5
2019-10-01,South Carolina,0,0,1,1,0.5
2019-10-01,Nevada,1,0,0,1,1.0
2019-10-01,New Hampshire,0,0,1,1,0.5
2019-10-01,Maryland,0,1,0,1,0.0
2019-10-01,Utah,1,0,0,1,1.0
2019-09-30,Arkansas,10,11,19,40,0.4875
2019-09-30,Hawaii,8,8,10,26,0.5
2019-09-30,California,20,9,16,45,0.6222222222222222
2019-09-30,Alabama,18,16,22,56,0.5178571428571429
2019-09-30,Michigan,3,2,3,8,0.5625
2019-09-30,Missouri,4,2,0,6,0.6666666666666666
2019-09-30,Indiana,5,7,16,28,0.4642857142857143
2019-09-30,Colorado,7,4,8,19,0.5789473684210527
2019-09-30,Delaware,11,3,4,18,0.7222222222222223
2019-09-30,North Carolina,2,0,0,2,1.0
2019-09-30,Maryland,0,1,3,4,0.375
2019-09-30,North Dakota,0,0,1,1,0.5
2019-09-30,Illinois,13,5,8,26,0.6538461538461539
2019-09-30,Florida,4,5,7,16,0.46875
2019-09-30,Connecticut,1,0,2,3,0.6666666666666666
2019-09-30,Georgia,8,1,12,21,0.6666666666666666
2019-09-30,New York,7,4,9,20,0.575
2019-09-30,Louisiana,2,7,5,14,0.3214285714285714
2019-09-30,Massachusetts,8,5,5,18,0.5833333333333333
2019-09-30,Iowa,3,1,3,7,0.6428571428571428
2019-09-30,Nebraska,6,1,3,10,0.75
2019-09-30,Minnesota,0,1,0,1,0.0
2019-09-30,Texas,3,5,6,14,0.42857142857142855
2019-09-30,New Hampshire,0,0,1,1,0.5
2019-09-30,Alaska,3,2,3,8,0.5625
2019-09-30,New Jersey,0,1,1,2,0.25
2019-09-30,Kentucky,0,3,3,6,0.25
2019-09-30,Oregon,2,0,2,4,0.75
2019-09-30,Wisconsin,1,1,0,2,0.5
2019-09-30,Ohio,0,0,2,2,0.5
2019-09-30,Washington,3,0,5,8,0.6875
2019-09-30,Kansas,1,1,1,3,0.5
2019-09-30,Nevada,2,0,0,2,1.0
2019-09-30,Pennsylvania,1,1,1,3,0.5
2019-09-30,Maine,1,0,0,1,1.0
2019-09-30,Mississippi,0,0,1,1,0.5
2019-09-30,Arizona,4,3,4,11,0.5454545454545454
2019-09-30,Idaho,0,1,0,1,0.0
2019-09-29,California,8,2,14,24,0.625
2019-09-29,Alabama,10,1,8,19,0.7368421052631579
2019-09-29,New York,1,6,3,10,0.25
2019-09-29,Hawaii,2,6,3,11,0.3181818181818182
2019-09-29,Alaska,2,3,3,8,0.4375
2019-09-29,Delaware,1,0,4,5,0.6000000000000001
2019-09-29,Arkansas,2,3,10,15,0.4666666666666667
2019-09-29,Massachusetts,4,3,6,13,0.5384615384615385
2019-09-29,Indiana,2,4,4,10,0.4
2019-09-29,Maine,0,1,0,1,0.0
2019-09-29,Arizona,2,2,2,6,0.5
2019-09-29,Nebraska,2,1,2,5,0.6000000000000001
2019-09-29,Texas,3,2,1,6,0.5833333333333334
2019-09-29,Oregon,0,1,1,2,0.25
2019-09-29,Pennsylvania,0,0,1,1,0.5
2019-09-29,Maryland,0,0,1,1,0.5
2019-09-29,Florida,2,2,3,7,0.5
2019-09-29,Oklahoma,0,1,0,1,0.0
2019-09-29,Idaho,0,1,0,1,0.0
2019-09-29,Georgia,1,2,5,8,0.4375
2019-09-29,Illinois,0,0,5,5,0.5
2019-09-29,New Jersey,0,1,1,2,0.25
2019-09-29,Kentucky,0,1,0,1,0.0
2019-09-29,Washington,2,3,3,8,0.4375
2019-09-29,Kansas,0,1,0,1,0.0
2019-09-29,Colorado,0,2,4,6,0.3333333333333333
2019-09-29,Michigan,0,0,3,3,0.5
2019-09-29,Ohio,0,0,1,1,0.5
2019-09-29,North Dakota,0,1,0,1,0.0
2019-09-29,Connecticut,1,0,0,1,1.0
2019-09-29,Missouri,2,0,1,3,0.8333333333333333
2019-09-29,Nevada,0,0,1,1,0.5
2019-09-29,Minnesota,1,0,0,1,1.0
2019-09-29,Louisiana,0,0,1,1,0.5
2019-09-29,New Hampshire,1,0,0,1,1.0
2019-09-28,California,8,10,10,28,0.4642857142857143
2019-09-28,Delaware,4,4,4,12,0.5
2019-09-28,Georgia,0,1,2,3,0.3333333333333333
2019-09-28,Massachusetts,12,5,10,27,0.6296296296296295
2019-09-28,Arizona,3,0,1,4,0.875
2019-09-28,Nebraska,2,2,3,7,0.5
2019-09-28,Oregon,1,0,0,1,1.0
2019-09-28,Alabama,6,4,7,17,0.5588235294117647
2019-09-28,Florida,7,2,3,12,0.7083333333333334
2019-09-28,Indiana,3,7,12,22,0.40909090909090906
2019-09-28,Montana,0,0,1,1,0.5
2019-09-28,Arkansas,1,3,8,12,0.41666666666666663
2019-09-28,Washington,5,2,0,7,0.7142857142857143
2019-09-28,New York,5,3,3,11,0.5909090909090908
2019-09-28,Colorado,4,2,4,10,0.6000000000000001
2019-09-28,Oklahoma,0,0,1,1,0.5
2019-09-28,Louisiana,2,1,1,4,0.625
2019-09-28,Missouri,2,0,2,4,0.75
2019-09-28,Alaska,0,0,2,2,0.5
2019-09-28,Idaho,1,1,0,2,0.5
2019-09-28,Minnesota,4,1,0,5,0.8
2019-09-28,Ohio,2,1,1,4,0.625
2019-09-28,Hawaii,5,3,1,9,0.6111111111111112
2019-09-28,Illinois,0,4,3,7,0.21428571428571427
2019-09-28,Connecticut,0,0,1,1,0.5
2019-09-28,New Hampshire,3,0,1,4,0.875
2019-09-28,Texas,3,0,3,6,0.75
2019-09-28,Iowa,1,0,0,1,1.0
2019-09-28,New Jersey,1,0,0,1,1.0
2019-09-28,Maryland,1,0,0,1,1.0
2019-09-28,Kansas,0,0,1,1,0.5
2019-09-28,Virginia,0,0,1,1,0.5
2019-09-28,Pennsylvania,0,1,0,1,0.0
2019-09-27,Indiana,7,4,6,17,0.5882352941176471
2019-09-27,Hawaii,9,6,6,21,0.5714285714285714
2019-09-27,Alabama,22,7,14,43,0.6744186046511629
2019-09-27,Nebraska,13,6,7,26,0.6346153846153846
2019-09-27,California,28,14,25,67,0.6044776119402985
2019-09-27,Arkansas,12,5,18,35,0.6
2019-09-27,Massachusetts,22,14,20,56,0.5714285714285714
2019-09-27,Louisiana,1,2,1,4,0.375
2019-09-27,New York,5,6,12,23,0.4782608695652174
2019-09-27,Florida,3,2,5,10,0.55
2019-09-27,Kansas,3,0,2,5,0.8
2019-09-27,Missouri,3,1,4,8,0.625
2019-09-27,Illinois,4,4,4,12,0.5
2019-09-27,Maryland,2,0,1,3,0.8333333333333333
2019-09-27,New Hampshire,1,0,0,1,1.0
2019-09-27,Oregon,0,1,1,2,0.25
2019-09-27,New Jersey,0,0,2,2,0.5
2019-09-27,Georgia,1,2,6,9,0.4444444444444444
2019-09-27,Delaware,2,3,4,9,0.4444444444444444
2019-09-27,Pennsylvania,1,0,1,2,0.75
2019-09-27,Arizona,3,4,6,13,0.46153846153846156
2019-09-27,Iowa,0,0,4,4,0.5
2019-09-27,Colorado,4,1,3,8,0.6875
2019-09-27,Oklahoma,0,0,1,1,0.5
2019-09-27,Connecticut,1,0,0,1,1.0
2019-09-27,Washington,1,4,1,6,0.25
2019-09-27,Michigan,3,1,0,4,0.75
2019-09-27,Minnesota,0,1,1,2,0.25
2019-09-27,Maine,0,2,1,3,0.16666666666666666
2019-09-27,Virginia,0,1,0,1,0.0
2019-09-27,Alaska,1,0,1,2,0.75
2019-09-27,Idaho,0,2,1,3,0.16666666666666666
2019-09-27,Ohio,1,0,0,1,1.0
2019-09-27,Texas,9,3,5,17,0.6764705882352942
2019-09-27,Utah,1,1,0,2,0.5
2019-09-27,Kentucky,0,1,0,1,0.0
2019-09-27,Rhode Island,1,0,0,1,1.0
2019-09-27,North Carolina,0,0,1,1,0.5
2019-09-27,Mississippi,0,0,1,1,0.5
2019-09-26,Indiana,4,9,3,16,0.34375
2019-09-26,California,27,4,18,49,0.7346938775510203
2019-09-26,Florida,5,0,9,14,0.6785714285714286
2019-09-26,Georgia,3,5,5,13,0.42307692307692313
2019-09-26,Arizona,2,1,0,3,0.6666666666666666
2019-09-26,Colorado,2,3,0,5,0.4
2019-09-26,Massachusetts,15,11,24,50,0.54
2019-09-26,Louisiana,3,1,2,6,0.6666666666666666
2019-09-26,Texas,2,3,2,7,0.42857142857142855
2019-09-26,Arkansas,6,4,11,21,0.5476190476190477
2019-09-26,Hawaii,8,2,9,19,0.6578947368421052
2019-09-26,Alabama,15,8,12,35,0.6
2019-09-26,Missouri,0,1,3,4,0.375
2019-09-26,New Hampshire,2,0,0,2,1.0
2019-09-26,Connecticut,0,1,1,2,0.25
2019-09-26,Delaware,2,2,2,6,0.5
2019-09-26,New York,8,8,8,24,0.5
2019-09-26,New Jersey,0,0,2,2,0.5
2019-09-26,Iowa,1,0,1,2,0.75
2019-09-26,Michigan,0,0,4,4,0.5
2019-09-26,Illinois,1,2,2,5,0.4
2019-09-26,Kentucky,1,1,1,3,0.5
2019-09-26,Alaska,3,1,1,5,0.7
2019-09-26,Idaho,1,2,0,3,0.3333333333333333
2019-09-26,Washington,1,0,1,2,0.75
2019-09-26,Nebraska,6,2,3,11,0.6818181818181818
2019-09-26,Minnesota,1,0,0,1,1.0
2019-09-26,Virginia,0,1,0,1,0.0
2019-09-26,Oregon,0,2,0,2,0.0
2019-09-26,Pennsylvania,1,0,0,1,1.0
2019-09-26,Kansas,0,0,1,1,0.5
2019-09-26,Maryland,0,1,0,1,0.0
2019-09-25,Florida,4,7,7,18,0.41666666666666663
2019-09-25,Alabama,10,8,11,29,0.5344827586206897
2019-09-25,Massachusetts,48,12,25,85,0.711764705882353
2019-09-25,Alaska,8,4,3,15,0.6333333333333333
2019-09-25,New York,13,6,13,32,0.609375
2019-09-25,Louisiana,1,3,0,4,0.25
2019-09-25,Indiana,10,0,6,16,0.8125
2019-09-25,California,30,18,24,72,0.5833333333333334
2019-09-25,Texas,3,3,2,8,0.5
2019-09-25,Hawaii,11,5,11,27,0.611111111111111
2019-09-25,Delaware,5,1,4,10,0.7
2019-09-25,Arkansas,8,8,12,28,0.5
2019-09-25,Idaho,1,2,0,3,0.3333333333333333
2019-09-25,Georgia,6,1,4,11,0.7272727272727273
2019-09-25,Wisconsin,1,0,1,2,0.75
2019-09-25,Nebraska,9,3,2,14,0.7142857142857143
2019-09-25,Nevada,1,0,1,2,0.75
2019-09-25,Colorado,5,4,7,16,0.53125
2019-09-25,Maryland,1,1,1,3,0.5
2019-09-25,Kansas,1,1,0,2,0.5
2019-09-25,Kentucky,0,2,1,3,0.16666666666666666
2019-09-25,Illinois,2,2,3,7,0.5
2019-09-25,Michigan,0,3,1,4,0.125
2019-09-25,Ohio,1,0,2,3,0.6666666666666666
2019-09-25,Arizona,3,2,3,8,0.5625
2019-09-25,Iowa,2,2,0,4,0.5
2019-09-25,Pennsylvania,0,1,2,3,0.3333333333333333
2019-09-25,Maine,1,0,0,1,1.0
2019-09-25,New Jersey,1,1,2,4,0.5
2019-09-25,Connecticut,2,0,0,2,1.0
2019-09-25,Rhode Island,0,0,1,1,0.5
2019-09-25,Missouri,1,0,0,1,1.0
2019-09-25,North Carolina,0,1,0,1,0.0
2019-09-25,Washington,1,0,0,1,1.0
2019-09-24,North Carolina,0,0,1,1,0.5
2019-09-24,California,41,24,39,104,0.5817307692307692
2019-09-24,Alaska,6,8,6,20,0.44999999999999996
2019-09-24,Arkansas,13,19,16,48,0.4375
2019-09-24,Georgia,3,8,11,22,0.38636363636363635
2019-09-24,New York,8,5,8,21,0.5714285714285714
2019-09-24,Missouri,3,5,3,11,0.40909090909090906
2019-09-24,Oklahoma,1,0,3,4,0.625
2019-09-24,Massachusetts,70,31,37,138,0.641304347826087
2019-09-24,Illinois,7,5,4,16,0.5625
2019-09-24,Hawaii,9,7,7,23,0.5434782608695652
2019-09-24,Colorado,7,2,3,12,0.7083333333333334
2019-09-24,Florida,8,20,12,40,0.35
2019-09-24,Indiana,13,19,10,42,0.4285714285714286
2019-09-24,Louisiana,2,9,4,15,0.26666666666666666
2019-09-24,Michigan,3,0,3,6,0.75
2019-09-24,Iowa,3,2,6,11,0.5454545454545454
2019-09-24,Washington,3,2,5,10,0.55
2019-09-24,Alabama,11,7,19,37,0.5540540540540541
2019-09-24,Arizona,5,1,4,10,0.7
2019-09-24,Nebraska,5,13,6,24,0.33333333333333337
2019-09-24,Connecticut,2,3,2,7,0.42857142857142855
2019-09-24,Idaho,1,4,5,10,0.35
2019-09-24,New Jersey,4,3,4,11,0.5454545454545454
2019-09-24,Delaware,2,4,4,10,0.4
2019-09-24,Pennsylvania,2,0,3,5,0.7
2019-09-24,Virginia,1,0,2,3,0.6666666666666666
2019-09-24,Maine,0,1,1,2,0.25
2019-09-24,Maryland,0,0,2,2,0.5
2019-09-24,Texas,5,11,6,22,0.36363636363636365
2019-09-24,Ohio,0,1,0,1,0.0
2019-09-24,Rhode Island,2,3,4,9,0.4444444444444444
2019-09-24,South Carolina,1,0,0,1,1.0
2019-09-24,Oregon,4,1,1,6,0.75
2019-09-24,Minnesota,0,0,2,2,0.5
2019-09-24,North Dakota,0,0,1,1,0.5
2019-09-24,Nevada,0,1,0,1,0.0
2019-09-24,Kansas,0,1,2,3,0.3333333333333333
2019-09-24,Mississippi,0,0,1,1,0.5
2019-09-24,New Hampshire,1,0,0,1,1.0
2019-09-24,Kentucky,0,0,1,1,0.5
2019-09-23,Florida,20,14,14,48,0.5625
2019-09-23,Illinois,4,5,8,17,0.47058823529411764
2019-09-23,California,37,16,37,90,0.6166666666666667
2019-09-23,Indiana,22,9,12,43,0.6511627906976745
2019-09-23,Massachusetts,95,52,57,204,0.6053921568627452
2019-09-23,New York,12,3,18,33,0.6363636363636364
2019-09-23,Hawaii,29,11,14,54,0.6666666666666667
2019-09-23,Colorado,7,10,5,22,0.4318181818181818
2019-09-23,Nebraska,14,7,9,30,0.6166666666666667
2019-09-23,Alabama,23,23,25,71,0.5
2019-09-23,Minnesota,3,0,0,3,1.0
2019-09-23,Oregon,4,4,2,10,0.5
2019-09-23,Georgia,5,11,13,29,0.39655172413793105
2019-09-23,Iowa,3,4,6,13,0.46153846153846156
2019-09-23,Texas,6,11,7,24,0.39583333333333337
2019-09-23,Arizona,9,3,6,18,0.6666666666666666
2019-09-23,Louisiana,3,4,11,18,0.4722222222222222
2019-09-23,Arkansas,24,15,21,60,0.575
2019-09-23,Utah,1,1,1,3,0.5
2019-09-23,Washington,5,4,2,11,0.5454545454545454
2019-09-23,Alaska,5,2,5,12,0.625
2019-09-23,Michigan,3,8,0,11,0.2727272727272727
2019-09-23,Missouri,4,5,3,12,0.4583333333333333
2019-09-23,Ohio,2,0,0,2,1.0
2019-09-23,Delaware,5,5,8,18,0.5
2019-09-23,Idaho,3,0,2,5,0.8
2019-09-23,Kentucky,1,3,4,8,0.375
2019-09-23,Maryland,1,2,4,7,0.42857142857142855
2019-09-23,Rhode Island,0,1,1,2,0.25
2019-09-23,Connecticut,1,2,2,5,0.4
2019-09-23,Pennsylvania,2,0,2,4,0.75
2019-09-23,Kansas,0,1,1,2,0.25
2019-09-23,Mississippi,1,0,1,2,0.75
2019-09-23,Maine,1,2,0,3,0.3333333333333333
2019-09-23,New Jersey,2,1,2,5,0.6000000000000001
2019-09-23,Virginia,0,0,1,1,0.5
2019-09-23,Oklahoma,0,0,1,1,0.5
2019-09-23,West Virginia,1,0,0,1,1.0
2019-09-23,North Dakota,0,1,0,1,0.0
2019-09-22,Indiana,9,4,9,22,0.6136363636363636
2019-09-22,Massachusetts,41,15,30,86,0.6511627906976745
2019-09-22,Michigan,2,1,2,5,0.6000000000000001
2019-09-22,Alaska,2,1,1,4,0.625
2019-09-22,California,19,12,15,46,0.5760869565217391
2019-09-22,Alabama,8,13,15,36,0.4305555555555556
2019-09-22,Texas,2,3,3,8,0.4375
2019-09-22,Arkansas,7,5,6,18,0.5555555555555556
2019-09-22,Georgia,6,3,7,16,0.59375
2019-09-22,Colorado,8,6,6,20,0.55
2019-09-22,Louisiana,3,4,3,10,0.44999999999999996
2019-09-22,New York,4,1,1,6,0.75
2019-09-22,Minnesota,2,1,0,3,0.6666666666666666
2019-09-22,Arizona,2,5,4,11,0.36363636363636365
2019-09-22,Florida,4,4,3,11,0.5
2019-09-22,Iowa,1,1,2,4,0.5
2019-09-22,Connecticut,2,0,0,2,1.0
2019-09-22,Missouri,2,2,1,5,0.5
2019-09-22,Oregon,1,2,0,3,0.3333333333333333
2019-09-22,Idaho,0,2,0,2,0.0
2019-09-22,Delaware,2,3,1,6,0.41666666666666663
2019-09-22,Nebraska,5,1,5,11,0.6818181818181818
2019-09-22,Hawaii,3,1,3,7,0.6428571428571428
2019-09-22,Pennsylvania,4,3,0,7,0.5714285714285714
2019-09-22,Maryland,2,2,2,6,0.5
2019-09-22,Illinois,3,3,3,9,0.5
2019-09-22,Kansas,1,0,0,1,1.0
2019-09-22,Kentucky,0,0,1,1,0.5
2019-09-22,Nevada,1,0,0,1,1.0
2019-09-22,Ohio,0,0,1,1,0.5
2019-09-22,North Carolina,0,0,1,1,0.5
2019-09-22,New Jersey,0,1,1,2,0.25
2019-09-21,Louisiana,15,6,11,32,0.640625
2019-09-21,Illinois,18,1,0,19,0.9473684210526315
2019-09-21,California,43,21,50,114,0.5964912280701754
2019-09-21,Massachusetts,72,31,48,151,0.6357615894039735
2019-09-21,Alabama,20,15,14,49,0.5510204081632653
2019-09-21,Pennsylvania,4,2,1,7,0.6428571428571428
2019-09-21,Hawaii,20,8,11,39,0.6538461538461537
2019-09-21,Indiana,15,12,17,44,0.5340909090909091
2019-09-21,Delaware,16,8,5,29,0.6379310344827587
2019-09-21,Oregon,1,2,5,8,0.4375
2019-09-21,Florida,14,6,8,28,0.6428571428571428
2019-09-21,Missouri,8,2,3,13,0.7307692307692308
2019-09-21,Texas,7,4,6,17,0.5882352941176471
2019-09-21,Colorado,14,5,9,28,0.6607142857142857
2019-09-21,New York,15,5,12,32,0.65625
2019-09-21,Arkansas,20,8,14,42,0.6428571428571428
2019-09-21,Nebraska,17,5,9,31,0.6935483870967741
2019-09-21,Washington,5,2,2,9,0.6666666666666667
2019-09-21,Georgia,8,2,8,18,0.6666666666666666
2019-09-21,Minnesota,2,2,1,5,0.5
2019-09-21,Michigan,1,4,2,7,0.2857142857142857
2019-09-21,Virginia,1,0,1,2,0.75
2019-09-21,Ohio,3,0,2,5,0.8
2019-09-21,Alaska,0,2,4,6,0.3333333333333333
2019-09-21,Arizona,2,4,7,13,0.4230769230769231
2019-09-21,Iowa,5,0,3,8,0.8125
2019-09-21,North Carolina,0,1,1,2,0.25
2019-09-21,Maryland,5,2,1,8,0.6875
2019-09-21,Kansas,4,0,3,7,0.7857142857142857
2019-09-21,Connecticut,2,0,2,4,0.75
2019-09-21,South Carolina,1,2,1,4,0.375
2019-09-21,Idaho,1,1,2,4,0.5
2019-09-21,New Jersey,2,3,0,5,0.4
2019-09-21,Oklahoma,0,2,1,3,0.16666666666666666
2019-09-21,Montana,1,0,0,1,1.0
2019-09-21,Rhode Island,0,0,1,1,0.5
2019-09-20,Louisiana,60,29,41,130,0.6192307692307693
2019-09-20,Alabama,107,45,87,239,0.6297071129707112
2019-09-20,Illinois,43,19,33,95,0.6263157894736843
2019-09-20,California,324,130,248,702,0.6381766381766382
2019-09-20,Indiana,99,43,66,208,0.6346153846153846
2019-09-20,Colorado,78,20,63,161,0.6801242236024845
2019-09-20,Minnesota,23,3,14,40,0.75
2019-09-20,Florida,44,16,20,80,0.675
2019-09-20,Hawaii,142,53,126,321,0.6386292834890965
2019-09-20,Kansas,7,5,15,27,0.537037037037037
2019-09-20,Missouri,38,10,14,62,0.7258064516129032
2019-09-20,Massachusetts,298,130,217,645,0.6302325581395349
2019-09-20,New York,77,30,62,169,0.6390532544378698
2019-09-20,Delaware,65,31,48,144,0.6180555555555556
2019-09-20,Arkansas,88,20,67,175,0.6942857142857143
2019-09-20,Texas,33,13,20,66,0.6515151515151515
2019-09-20,Alaska,12,8,21,41,0.5487804878048781
2019-09-20,Pennsylvania,13,6,6,25,0.64
2019-09-20,Iowa,16,5,7,28,0.6964285714285714
2019-09-20,Connecticut,15,5,8,28,0.6785714285714286
2019-09-20,Nebraska,51,20,35,106,0.6462264150943396
2019-09-20,Washington,50,12,22,84,0.7261904761904762
2019-09-20,Oregon,13,5,7,25,0.66
2019-09-20,Nevada,4,0,0,4,1.0
2019-09-20,Idaho,9,7,11,27,0.537037037037037
2019-09-20,Georgia,28,11,24,63,0.6349206349206349
2019-09-20,Michigan,16,3,3,22,0.7954545454545454
2019-09-20,Maine,2,1,5,8,0.5625
2019-09-20,Ohio,7,2,7,16,0.65625
2019-09-20,Arizona,19,14,20,53,0.5471698113207547
2019-09-20,New Jersey,6,3,8,17,0.5882352941176471
2019-09-20,Montana,3,1,0,4,0.75
2019-09-20,Maryland,5,2,5,12,0.625
2019-09-20,Oklahoma,1,0,0,1,1.0
2019-09-20,New Hampshire,3,2,0,5,0.6
2019-09-20,New Mexico,0,0,3,3,0.5
2019-09-20,Rhode Island,4,2,1,7,0.6428571428571428
2019-09-20,Wisconsin,1,0,0,1,1.0
2019-09-20,North Carolina,5,3,5,13,0.576923076923077
2019-09-20,North Dakota,5,1,3,9,0.7222222222222222
2019-09-20,South Carolina,1,0,0,1,1.0
2019-09-20,Virginia,4,1,1,6,0.75
2019-09-20,Utah,1,0,2,3,0.6666666666666666
2019-09-20,Kentucky,2,2,1,5,0.5
2019-09-19,Massachusetts,27,8,21,56,0.6696428571428572
2019-09-19,Indiana,15,10,13,38,0.5657894736842105
2019-09-19,California,32,12,20,64,0.65625
2019-09-19,Louisiana,6,5,8,19,0.5263157894736842
2019-09-19,Texas,7,3,10,20,0.6
2019-09-19,New Jersey,6,0,0,6,1.0
2019-09-19,Missouri,4,1,4,9,0.6666666666666666
2019-09-19,Alabama,12,6,19,37,0.5810810810810811
2019-09-19,Arizona,4,3,1,8,0.5625
2019-09-19,Kentucky,1,0,0,1,1.0
2019-09-19,Alaska,5,0,3,8,0.8125
2019-09-19,Delaware,6,2,3,11,0.6818181818181818
2019-09-19,Florida,5,1,7,13,0.6538461538461539
2019-09-19,Colorado,10,4,4,18,0.6666666666666667
2019-09-19,New York,11,8,5,24,0.5625
2019-09-19,Washington,2,1,1,4,0.625
2019-09-19,Hawaii,12,6,9,27,0.611111111111111
2019-09-19,Oregon,0,0,2,2,0.5
2019-09-19,Arkansas,10,7,8,25,0.56
2019-09-19,Illinois,2,4,3,9,0.38888888888888884
2019-09-19,Connecticut,3,0,1,4,0.875
2019-09-19,Nebraska,2,1,2,5,0.6000000000000001
2019-09-19,Georgia,4,0,5,9,0.7222222222222222
2019-09-19,Utah,1,0,0,1,1.0
2019-09-19,Idaho,1,2,1,4,0.375
2019-09-19,Iowa,3,2,0,5,0.6
2019-09-19,Minnesota,0,0,2,2,0.5
2019-09-19,Pennsylvania,2,1,1,4,0.625
2019-09-19,Michigan,2,1,1,4,0.625
2019-09-19,Ohio,0,1,1,2,0.25
2019-09-19,Virginia,1,0,0,1,1.0
2019-09-19,Kansas,1,0,1,2,0.75
2019-09-19,North Carolina,0,1,0,1,0.0
2019-09-19,New Mexico,1,0,0,1,1.0
2019-09-19,North Dakota,0,1,0,1,0.0
2019-09-19,Maryland,1,0,0,1,1.0
2019-09-19,Oklahoma,1,0,0,1,1.0
2019-09-18,California,17,5,17,39,0.6538461538461539
2019-09-18,Illinois,0,4,6,10,0.3
2019-09-18,Arkansas,9,7,7,23,0.5434782608695652
2019-09-18,Alabama,7,5,10,22,0.5454545454545454
2019-09-18,Louisiana,3,3,4,10,0.5
2019-09-18,Florida,3,5,2,10,0.4
2019-09-18,Texas,1,1,3,5,0.5
2019-09-18,Massachusetts,6,6,12,24,0.5
2019-09-18,Hawaii,16,11,16,43,0.5581395348837209
2019-09-18,Georgia,3,3,3,9,0.5
2019-09-18,Delaware,1,3,4,8,0.375
2019-09-18,Indiana,9,6,6,21,0.5714285714285714
2019-09-18,Minnesota,1,0,0,1,1.0
2019-09-18,New York,3,3,0,6,0.5
2019-09-18,New Jersey,1,1,0,2,0.5
2019-09-18,Colorado,9,4,2,15,0.6666666666666666
2019-09-18,Iowa,0,1,2,3,0.3333333333333333
2019-09-18,Nebraska,2,0,2,4,0.75
2019-09-18,Kansas,0,1,1,2,0.25
2019-09-18,Washington,2,1,2,5,0.6000000000000001
2019-09-18,Alaska,4,3,3,10,0.55
2019-09-18,Idaho,0,0,3,3,0.5
2019-09-18,Arizona,2,1,3,6,0.5833333333333333
2019-09-18,Kentucky,1,0,1,2,0.75
2019-09-18,Michigan,1,0,1,2,0.75
2019-09-18,Maryland,0,0,1,1,0.5
2019-09-18,Missouri,0,1,0,1,0.0
2019-09-18,New Hampshire,0,0,1,1,0.5
2019-09-18,Pennsylvania,1,0,0,1,1.0
2019-09-18,Wisconsin,1,0,0,1,1.0
2019-09-18,New Mexico,1,0,1,2,0.75
2019-09-18,Connecticut,0,1,0,1,0.0
2019-09-17,Massachusetts,11,4,13,28,0.625
2019-09-17,California,9,8,5,22,0.5227272727272727
2019-09-17,Texas,3,0,1,4,0.875
2019-09-17,Arizona,1,0,2,3,0.6666666666666666
2019-09-17,New Jersey,0,1,2,3,0.3333333333333333
2019-09-17,Alabama,6,11,3,20,0.375
2019-09-17,Colorado,3,2,3,8,0.5625
2019-09-17,Rhode Island,3,0,7,10,0.6499999999999999
2019-09-17,Hawaii,3,4,3,10,0.44999999999999996
2019-09-17,Florida,6,0,3,9,0.8333333333333333
2019-09-17,New York,7,2,6,15,0.6666666666666667
2019-09-17,Delaware,2,2,2,6,0.5
2019-09-17,Washington,2,1,1,4,0.625
2019-09-17,Alaska,3,1,1,5,0.7
2019-09-17,Illinois,3,0,3,6,0.75
2019-09-17,Indiana,2,2,5,9,0.5
2019-09-17,Nebraska,0,4,2,6,0.16666666666666666
2019-09-17,Arkansas,6,4,5,15,0.5666666666666667
2019-09-17,Virginia,0,0,1,1,0.5
2019-09-17,Iowa,0,1,0,1,0.0
2019-09-17,Louisiana,3,0,2,5,0.8
2019-09-17,Missouri,2,0,4,6,0.6666666666666666
2019-09-17,Maryland,0,1,0,1,0.0
2019-09-17,Georgia,0,0,5,5,0.5
2019-09-17,Idaho,1,0,0,1,1.0
2019-09-17,West Virginia,1,0,0,1,1.0
2019-09-17,Michigan,1,0,1,2,0.75
2019-09-17,Kansas,1,0,1,2,0.75
2019-09-17,Mississippi,0,0,1,1,0.5
2019-09-16,Indiana,7,2,5,14,0.6785714285714286
2019-09-16,California,14,6,11,31,0.6290322580645161
2019-09-16,Arkansas,3,1,5,9,0.6111111111111112
2019-09-16,Florida,1,2,2,5,0.4
2019-09-16,Delaware,3,3,2,8,0.5
2019-09-16,New York,4,2,6,12,0.5833333333333333
2019-09-16,Louisiana,3,3,2,8,0.5
2019-09-16,Colorado,3,1,2,6,0.6666666666666666
2019-09-16,Alabama,6,5,9,20,0.525
2019-09-16,Alaska,0,2,1,3,0.16666666666666666
2019-09-16,Illinois,2,3,3,8,0.4375
2019-09-16,Michigan,0,2,2,4,0.25
2019-09-16,Massachusetts,5,3,10,18,0.5555555555555556
2019-09-16,Georgia,0,1,3,4,0.375
2019-09-16,Kansas,1,0,0,1,1.0
2019-09-16,Iowa,0,1,1,2,0.25
2019-09-16,Hawaii,9,5,6,20,0.6
2019-09-16,Minnesota,1,1,0,2,0.5
2019-09-16,New Jersey,2,0,1,3,0.8333333333333333
2019-09-16,Arizona,3,3,2,8,0.5
2019-09-16,Washington,0,0,1,1,0.5
2019-09-16,Nebraska,0,0,3,3,0.5
2019-09-16,Pennsylvania,1,1,1,3,0.5
2019-09-16,Texas,2,1,0,3,0.6666666666666666
2019-09-16,Missouri,1,0,1,2,0.75
2019-09-16,New Hampshire,0,0,1,1,0.5
2019-09-16,Rhode Island,0,0,1,1,0.5
2019-09-16,Oregon,1,0,0,1,1.0
2019-09-16,Virginia,0,0,1,1,0.5
2019-09-16,Tennessee,0,1,0,1,0.0
2019-09-16,Maryland,1,0,0,1,1.0
2019-09-16,Nevada,0,0,1,1,0.5
2019-09-15,Louisiana,7,1,2,10,0.7999999999999999
2019-09-15,Missouri,4,2,3,9,0.611111111111111
2019-09-15,California,7,6,7,20,0.5249999999999999
2019-09-15,Texas,4,3,1,8,0.5625
2019-09-15,Alabama,4,8,7,19,0.39473684210526316
2019-09-15,Delaware,0,0,3,3,0.5
2019-09-15,New Jersey,1,0,0,1,1.0
2019-09-15,Iowa,0,2,0,2,0.0
2019-09-15,Arizona,0,1,2,3,0.3333333333333333
2019-09-15,Arkansas,2,3,4,9,0.4444444444444444
2019-09-15,Alaska,2,1,2,5,0.6000000000000001
2019-09-15,Indiana,2,0,1,3,0.8333333333333333
2019-09-15,Connecticut,1,0,1,2,0.75
2019-09-15,New York,2,0,0,2,1.0
2019-09-15,Pennsylvania,0,0,1,1,0.5
2019-09-15,Kentucky,0,0,1,1,0.5
2019-09-15,Colorado,5,1,2,8,0.75
2019-09-15,Illinois,1,2,1,4,0.375
2019-09-15,Hawaii,3,1,2,6,0.6666666666666666
2019-09-15,Florida,2,3,1,6,0.41666666666666663
2019-09-15,Georgia,0,1,0,1,0.0
2019-09-15,Massachusetts,2,0,4,6,0.6666666666666666
2019-09-15,Nevada,0,1,0,1,0.0
2019-09-15,Michigan,0,2,0,2,0.0
2019-09-15,Nebraska,0,0,1,1,0.5
2019-09-14,Georgia,1,2,2,5,0.4
2019-09-14,Missouri,2,0,2,4,0.75
2019-09-14,Arizona,5,0,0,5,1.0
2019-09-14,Massachusetts,4,4,4,12,0.5
2019-09-14,Colorado,3,2,1,6,0.5833333333333334
2019-09-14,New York,0,3,2,5,0.2
2019-09-14,Connecticut,1,0,1,2,0.75
2019-09-14,California,7,5,6,18,0.5555555555555556
2019-09-14,Illinois,1,0,2,3,0.6666666666666666
2019-09-14,Indiana,4,4,4,12,0.5
2019-09-14,Alabama,6,7,3,16,0.46875
2019-09-14,Michigan,1,0,1,2,0.75
2019-09-14,Nebraska,1,2,1,4,0.375
2019-09-14,Arkansas,5,7,3,15,0.43333333333333335
2019-09-14,Iowa,1,0,1,2,0.75
2019-09-14,Florida,2,2,1,5,0.5
2019-09-14,Alaska,0,1,2,3,0.3333333333333333
2019-09-14,Hawaii,3,1,1,5,0.7
2019-09-14,Texas,0,0,1,1,0.5
2019-09-14,Louisiana,0,0,3,3,0.5
2019-09-14,Kentucky,0,1,1,2,0.25
2019-09-14,Delaware,3,1,1,5,0.7
2019-09-14,Idaho,1,0,2,3,0.6666666666666666
2019-09-14,New Jersey,0,1,0,1,0.0
2019-09-14,Oklahoma,1,0,0,1,1.0
2019-09-14,Oregon,1,0,0,1,1.0
2019-09-14,Maryland,0,1,0,1,0.0
2019-09-13,New York,1,1,3,5,0.5
2019-09-13,Alabama,4,3,6,13,0.5384615384615385
2019-09-13,Connecticut,0,1,0,1,0.0
2019-09-13,Arkansas,1,3,11,15,0.4333333333333333
2019-09-13,Massachusetts,9,2,5,16,0.71875
2019-09-13,California,6,10,12,28,0.42857142857142855
2019-09-13,Missouri,3,0,0,3,1.0
2019-09-13,Iowa,2,0,1,3,0.8333333333333333
2019-09-13,Illinois,3,1,2,6,0.6666666666666666
2019-09-13,Arizona,3,2,0,5,0.6
2019-09-13,Hawaii,10,4,8,22,0.6363636363636364
2019-09-13,Florida,2,3,1,6,0.41666666666666663
2019-09-13,Indiana,2,1,6,9,0.5555555555555556
2019-09-13,Delaware,6,5,4,15,0.5333333333333333
2019-09-13,New Jersey,0,1,1,2,0.25
2019-09-13,Colorado,1,1,2,4,0.5
2019-09-13,Nebraska,0,1,0,1,0.0
2019-09-13,Alaska,2,0,0,2,1.0
2019-09-13,Texas,0,2,3,5,0.3
2019-09-13,Maine,0,0,1,1,0.5
2019-09-13,Louisiana,2,0,0,2,1.0
2019-09-13,Maryland,3,1,0,4,0.75
2019-09-13,Georgia,3,0,4,7,0.7142857142857142
2019-09-13,Minnesota,1,0,0,1,1.0
2019-09-13,Oregon,0,0,1,1,0.5
2019-09-13,North Carolina,1,0,0,1,1.0
2019-09-13,Kansas,0,0,1,1,0.5
2019-09-13,Idaho,1,0,0,1,1.0
2019-09-12,California,13,6,9,28,0.625
2019-09-12,Alabama,7,7,13,27,0.5
2019-09-12,Georgia,2,1,4,7,0.5714285714285714
2019-09-12,New York,2,4,3,9,0.38888888888888884
2019-09-12,Arkansas,2,3,5,10,0.45
2019-09-12,Delaware,6,1,5,12,0.7083333333333334
2019-09-12,Massachusetts,4,4,5,13,0.5
2019-09-12,Texas,2,1,7,10,0.55
2019-09-12,Florida,2,1,5,8,0.5625
2019-09-12,Indiana,5,3,9,17,0.5588235294117647
2019-09-12,Colorado,4,0,3,7,0.7857142857142857
2019-09-12,Pennsylvania,0,0,1,1,0.5
2019-09-12,Iowa,2,2,0,4,0.5
2019-09-12,Louisiana,1,1,4,6,0.5
2019-09-12,Missouri,4,0,2,6,0.8333333333333333
2019-09-12,New Hampshire,0,1,1,2,0.25
2019-09-12,Hawaii,3,1,6,10,0.6
2019-09-12,Connecticut,2,0,1,3,0.8333333333333333
2019-09-12,Kansas,0,2,1,3,0.16666666666666666
2019-09-12,Illinois,3,1,1,5,0.7
2019-09-12,Maryland,2,2,0,4,0.5
2019-09-12,Nevada,1,0,0,1,1.0
2019-09-12,Virginia,1,0,0,1,1.0
2019-09-12,Kentucky,0,1,0,1,0.0
2019-09-12,Maine,1,0,0,1,1.0
2019-09-12,Mississippi,1,0,0,1,1.0
2019-09-12,Alaska,0,1,1,2,0.25
2019-09-12,Michigan,1,0,0,1,1.0
2019-09-12,Washington,0,0,4,4,0.5
2019-09-12,Nebraska,1,1,0,2,0.5
2019-09-12,Rhode Island,0,1,0,1,0.0
2019-09-12,Idaho,0,1,0,1,0.0
2019-09-12,Arizona,1,0,1,2,0.75
2019-09-11,Louisiana,1,1,0,2,0.5
2019-09-11,Massachusetts,3,3,4,10,0.5
2019-09-11,Arkansas,3,0,4,7,0.7142857142857142
2019-09-11,New York,2,1,2,5,0.6000000000000001
2019-09-11,Alabama,2,3,3,8,0.4375
2019-09-11,Alaska,1,1,3,5,0.5
2019-09-11,Kentucky,0,1,0,1,0.0
2019-09-11,Hawaii,3,1,2,6,0.6666666666666666
2019-09-11,New Jersey,0,0,1,1,0.5
2019-09-11,Delaware,1,0,1,2,0.75
2019-09-11,Texas,2,1,1,4,0.625
2019-09-11,Kansas,1,1,0,2,0.5
2019-09-11,California,9,3,4,16,0.6875
2019-09-11,Indiana,2,0,1,3,0.8333333333333333
2019-09-11,Colorado,6,1,1,8,0.8125
2019-09-11,Florida,1,0,5,6,0.5833333333333334
2019-09-11,Iowa,2,1,1,4,0.625
2019-09-11,Missouri,1,0,1,2,0.75
2019-09-11,Virginia,1,1,0,2,0.5
2019-09-11,Minnesota,0,0,1,1,0.5
2019-09-11,Washington,1,0,0,1,1.0
2019-09-11,Arizona,0,1,1,2,0.25
2019-09-11,North Carolina,0,0,1,1,0.5
2019-09-11,Illinois,1,0,0,1,1.0
2019-09-11,Georgia,1,0,1,2,0.75
2019-09-11,Michigan,1,0,0,1,1.0
2019-09-10,Texas,1,1,2,4,0.5
2019-09-10,Hawaii,2,2,3,7,0.5
2019-09-10,Missouri,0,0,1,1,0.5
2019-09-10,New York,3,3,1,7,0.5
2019-09-10,California,6,2,7,15,0.6333333333333333
2019-09-10,Maryland,3,0,2,5,0.8
2019-09-10,Arkansas,3,5,5,13,0.42307692307692313
2019-09-10,Georgia,4,1,3,8,0.6875
2019-09-10,Delaware,0,0,1,1,0.5
2019-09-10,Washington,0,0,1,1,0.5
2019-09-10,Illinois,1,2,3,6,0.41666666666666663
2019-09-10,Oregon,1,3,2,6,0.3333333333333333
2019-09-10,Alabama,1,0,5,6,0.5833333333333334
2019-09-10,Colorado,1,2,3,6,0.41666666666666663
2019-09-10,Indiana,6,3,4,13,0.6153846153846154
2019-09-10,Massachusetts,3,1,4,8,0.625
2019-09-10,Michigan,0,0,2,2,0.5
2019-09-10,Louisiana,0,0,2,2,0.5
2019-09-10,Arizona,2,3,0,5,0.4
2019-09-10,Florida,0,1,1,2,0.25
2019-09-10,Alaska,0,0,2,2,0.5
2019-09-10,Idaho,0,0,1,1,0.5
2019-09-10,Connecticut,1,0,0,1,1.0
2019-09-10,Nebraska,0,1,0,1,0.0
2019-09-10,Pennsylvania,0,1,0,1,0.0
2019-09-09,Texas,3,1,1,5,0.7
2019-09-09,Florida,2,1,0,3,0.6666666666666666
2019-09-09,Louisiana,2,3,3,8,0.4375
2019-09-09,California,6,5,4,15,0.5333333333333333
2019-09-09,Hawaii,1,2,5,8,0.4375
2019-09-09,Colorado,3,4,2,9,0.4444444444444444
2019-09-09,Massachusetts,9,3,6,18,0.6666666666666666
2019-09-09,Nebraska,0,1,2,3,0.3333333333333333
2019-09-09,Alabama,1,5,3,9,0.2777777777777778
2019-09-09,Illinois,4,2,2,8,0.625
2019-09-09,Ohio,0,1,0,1,0.0
2019-09-09,Georgia,0,0,2,2,0.5
2019-09-09,Indiana,1,1,0,2,0.5
2019-09-09,Michigan,1,0,0,1,1.0
2019-09-09,Alaska,0,1,0,1,0.0
2019-09-09,Missouri,1,0,3,4,0.625
2019-09-09,New York,1,2,3,6,0.41666666666666663
2019-09-09,Arkansas,0,3,0,3,0.0
2019-09-09,New Hampshire,2,0,0,2,1.0
2019-09-09,North Dakota,0,0,1,1,0.5
2019-09-09,Delaware,1,1,2,4,0.5
2019-09-09,Oregon,1,1,0,2,0.5
2019-09-09,Arizona,2,0,1,3,0.8333333333333333
2019-09-09,Kansas,1,2,0,3,0.3333333333333333
2019-09-09,Minnesota,0,0,1,1,0.5
2019-09-09,Iowa,0,1,1,2,0.25
2019-09-09,Maryland,0,0,1,1,0.5
2019-09-09,Virginia,1,0,1,2,0.75
2019-09-09,Idaho,0,2,0,2,0.0
2019-09-09,New Jersey,0,0,1,1,0.5
2019-09-09,Washington,0,0,1,1,0.5
2019-09-08,New York,0,2,3,5,0.3
2019-09-08,Colorado,1,0,2,3,0.6666666666666666
2019-09-08,Nebraska,0,2,3,5,0.3
2019-09-08,Louisiana,1,0,1,2,0.75
2019-09-08,Delaware,0,3,1,4,0.125
2019-09-08,Arkansas,3,9,0,12,0.25
2019-09-08,Massachusetts,8,3,3,14,0.6785714285714285
2019-09-08,Alabama,8,5,2,15,0.6
2019-09-08,Idaho,0,0,1,1,0.5
2019-09-08,California,4,9,8,21,0.38095238095238093
2019-09-08,Pennsylvania,0,0,1,1,0.5
2019-09-08,Illinois,0,0,1,1,0.5
2019-09-08,Oregon,2,0,2,4,0.75
2019-09-08,Hawaii,2,0,2,4,0.75
2019-09-08,Missouri,0,0,1,1,0.5
2019-09-08,Connecticut,0,0,1,1,0.5
2019-09-08,Arizona,0,2,2,4,0.25
2019-09-08,Texas,1,1,2,4,0.5
2019-09-08,Georgia,0,2,3,5,0.3
2019-09-08,Alaska,0,1,1,2,0.25
2019-09-08,Michigan,0,0,1,1,0.5
2019-09-08,Indiana,3,1,0,4,0.75
2019-09-08,Minnesota,0,0,1,1,0.5
2019-09-08,Maryland,0,1,0,1,0.0
2019-09-08,Florida,0,2,2,4,0.25
2019-09-08,Iowa,1,0,1,2,0.75
2019-09-08,Kansas,0,0,1,1,0.5
2019-09-08,Oklahoma,0,1,0,1,0.0
2019-09-08,Washington,0,0,1,1,0.5
2019-09-07,Michigan,1,0,0,1,1.0
2019-09-07,Georgia,0,2,4,6,0.3333333333333333
2019-09-07,Indiana,3,3,2,8,0.5
2019-09-07,Alabama,2,5,4,11,0.36363636363636365
2019-09-07,Illinois,0,0,2,2,0.5
2019-09-07,Massachusetts,4,2,4,10,0.6000000000000001
2019-09-07,Kentucky,1,0,0,1,1.0
2019-09-07,Texas,0,2,2,4,0.25
2019-09-07,Delaware,2,1,2,5,0.6000000000000001
2019-09-07,West Virginia,0,0,1,1,0.5
2019-09-07,Kansas,0,0,1,1,0.5
2019-09-07,Alaska,1,0,1,2,0.75
2019-09-07,California,8,3,4,15,0.6666666666666666
2019-09-07,Florida,3,4,2,9,0.4444444444444444
2019-09-07,Hawaii,1,3,0,4,0.25
2019-09-07,Nebraska,2,0,1,3,0.8333333333333333
2019-09-07,Oregon,1,1,0,2,0.5
2019-09-07,New York,3,1,1,5,0.7
2019-09-07,Minnesota,0,1,0,1,0.0
2019-09-07,Arkansas,1,2,4,7,0.42857142857142855
2019-09-07,Missouri,1,1,1,3,0.5
2019-09-07,Arizona,2,2,1,5,0.5
2019-09-07,Maryland,1,0,1,2,0.75
2019-09-07,Iowa,0,2,0,2,0.0
2019-09-07,Colorado,2,1,2,5,0.6000000000000001
2019-09-07,North Carolina,0,1,1,2,0.25
2019-09-07,Utah,0,0,1,1,0.5
2019-09-07,Washington,0,1,1,2,0.25
2019-09-06,Indiana,3,4,7,14,0.4642857142857143
2019-09-06,Arkansas,4,9,5,18,0.3611111111111111
2019-09-06,Alaska,0,5,2,7,0.14285714285714285
2019-09-06,Georgia,2,1,2,5,0.6000000000000001
2019-09-06,Alabama,5,6,4,15,0.4666666666666667
2019-09-06,California,9,8,8,25,0.52
2019-09-06,Delaware,2,1,2,5,0.6000000000000001
2019-09-06,Hawaii,4,1,0,5,0.8
2019-09-06,Massachusetts,6,3,2,11,0.6363636363636364
2019-09-06,Ohio,2,2,1,5,0.5
2019-09-06,Arizona,3,6,4,13,0.38461538461538464
2019-09-06,Louisiana,2,3,2,7,0.42857142857142855
2019-09-06,Missouri,6,0,1,7,0.9285714285714285
2019-09-06,Mississippi,0,1,0,1,0.0
2019-09-06,Florida,1,1,3,5,0.5
2019-09-06,Kansas,0,0,2,2,0.5
2019-09-06,New York,2,0,2,4,0.75
2019-09-06,Illinois,2,1,4,7,0.5714285714285714
2019-09-06,Michigan,1,0,2,3,0.6666666666666666
2019-09-06,Maryland,1,0,1,2,0.75
2019-09-06,Maine,0,1,0,1,0.0
2019-09-06,Iowa,0,1,3,4,0.375
2019-09-06,Texas,0,0,2,2,0.5
2019-09-06,Pennsylvania,0,0,1,1,0.5
2019-09-06,Colorado,0,1,2,3,0.3333333333333333
2019-09-06,Nebraska,0,1,0,1,0.0
2019-09-06,Washington,0,2,0,2,0.0
2019-09-06,Idaho,0,1,0,1,0.0
2019-09-05,Massachusetts,7,5,9,21,0.5476190476190476
2019-09-05,Alaska,2,3,5,10,0.45
2019-09-05,Arkansas,7,14,13,34,0.39705882352941174
2019-09-05,Arizona,2,3,5,10,0.45
2019-09-05,Delaware,5,3,1,9,0.6111111111111112
2019-09-05,Indiana,7,8,11,26,0.4807692307692307
2019-09-05,Illinois,6,5,9,20,0.525
2019-09-05,Pennsylvania,2,2,2,6,0.5
2019-09-05,California,19,11,22,52,0.5769230769230769
2019-09-05,Oregon,0,2,3,5,0.3
2019-09-05,Missouri,1,0,3,4,0.625
2019-09-05,Washington,2,0,4,6,0.6666666666666666
2019-09-05,Oklahoma,0,2,0,2,0.0
2019-09-05,Alabama,3,7,5,15,0.3666666666666667
2019-09-05,Florida,0,5,4,9,0.2222222222222222
2019-09-05,Hawaii,0,6,7,13,0.2692307692307692
2019-09-05,Louisiana,3,7,7,17,0.38235294117647056
2019-09-05,Kansas,0,0,1,1,0.5
2019-09-05,Texas,5,3,4,12,0.5833333333333334
2019-09-05,Colorado,1,1,3,5,0.5
2019-09-05,New Jersey,2,1,4,7,0.5714285714285714
2019-09-05,New York,3,2,3,8,0.5625
2019-09-05,Georgia,0,3,5,8,0.3125
2019-09-05,Virginia,1,0,1,2,0.75
2019-09-05,New Hampshire,0,1,0,1,0.0
2019-09-05,Kentucky,1,1,0,2,0.5
2019-09-05,Idaho,1,0,2,3,0.6666666666666666
2019-09-05,Iowa,2,2,1,5,0.5
2019-09-05,South Carolina,1,0,0,1,1.0
2019-09-05,Michigan,2,1,0,3,0.6666666666666666
2019-09-05,Connecticut,1,1,1,3,0.5
2019-09-05,Minnesota,1,0,1,2,0.75
2019-09-05,Nebraska,2,2,1,5,0.5
2019-09-05,Maryland,0,1,0,1,0.0
2019-09-05,Ohio,0,0,1,1,0.5
2019-09-05,North Carolina,0,0,1,1,0.5
2019-09-05,North Dakota,8,0,0,8,1.0
2019-09-04,Hawaii,19,12,25,56,0.5625
2019-09-04,Delaware,12,3,8,23,0.6956521739130435
2019-09-04,Georgia,7,6,6,19,0.5263157894736842
2019-09-04,California,22,21,36,79,0.5063291139240507
2019-09-04,New York,20,10,26,56,0.5892857142857143
2019-09-04,Missouri,12,3,11,26,0.6730769230769231
2019-09-04,Indiana,33,19,37,89,0.5786516853932584
2019-09-04,Arkansas,20,25,26,71,0.46478873239436624
2019-09-04,Massachusetts,39,18,34,91,0.6153846153846154
2019-09-04,Florida,7,13,20,40,0.425
2019-09-04,Alabama,20,18,28,66,0.5151515151515151
2019-09-04,Washington,7,4,3,14,0.6071428571428571
2019-09-04,Illinois,19,9,18,46,0.6086956521739131
2019-09-04,Arizona,4,7,7,18,0.41666666666666663
2019-09-04,Kentucky,0,0,2,2,0.5
2019-09-04,Kansas,1,0,2,3,0.6666666666666666
2019-09-04,Maryland,5,3,5,13,0.576923076923077
2019-09-04,Ohio,0,1,2,3,0.3333333333333333
2019-09-04,Texas,5,9,8,22,0.40909090909090906
2019-09-04,Louisiana,5,5,2,12,0.5
2019-09-04,Virginia,1,0,3,4,0.625
2019-09-04,Nebraska,17,12,14,43,0.5581395348837209
2019-09-04,Colorado,6,3,9,18,0.5833333333333333
2019-09-04,Iowa,4,4,5,13,0.5
2019-09-04,Idaho,3,1,1,5,0.7
2019-09-04,Alaska,9,5,5,19,0.6052631578947368
2019-09-04,Connecticut,1,0,2,3,0.6666666666666666
2019-09-04,North Carolina,2,1,2,5,0.6000000000000001
2019-09-04,Michigan,1,4,1,6,0.25
2019-09-04,New Jersey,3,4,4,11,0.45454545454545453
2019-09-04,New Hampshire,1,1,1,3,0.5
2019-09-04,New Mexico,1,0,2,3,0.6666666666666666
2019-09-04,Maine,1,1,0,2,0.5
2019-09-04,Pennsylvania,2,1,2,5,0.6000000000000001
2019-09-04,Tennessee,1,0,0,1,1.0
2019-09-04,South Carolina,0,0,1,1,0.5
2019-09-04,Minnesota,0,2,0,2,0.0
2019-09-04,Rhode Island,0,0,1,1,0.5
2019-09-03,Colorado,2,0,4,6,0.6666666666666666
2019-09-03,Massachusetts,7,2,3,12,0.7083333333333334
2019-09-03,California,7,4,13,24,0.5625
2019-09-03,Texas,0,2,3,5,0.3
2019-09-03,Louisiana,2,0,3,5,0.7
2019-09-03,Iowa,1,0,3,4,0.625
2019-09-03,Hawaii,4,2,7,13,0.5769230769230769
2019-09-03,Illinois,4,3,4,11,0.5454545454545454
2019-09-03,Florida,5,4,4,13,0.5384615384615385
2019-09-03,Alabama,3,4,6,13,0.46153846153846156
2019-09-03,Idaho,0,1,0,1,0.0
2019-09-03,Arkansas,2,2,2,6,0.5
2019-09-03,New York,2,0,0,2,1.0
2019-09-03,Indiana,7,3,5,15,0.6333333333333333
2019-09-03,Missouri,0,1,1,2,0.25
2019-09-03,North Carolina,1,0,0,1,1.0
2019-09-03,Arizona,1,1,0,2,0.5
2019-09-03,Delaware,0,1,0,1,0.0
2019-09-03,Washington,0,0,2,2,0.5
2019-09-03,Oklahoma,1,0,0,1,1.0
2019-09-03,Georgia,1,1,2,4,0.5
2019-09-03,Alaska,1,2,0,3,0.3333333333333333
2019-09-03,Ohio,0,1,1,2,0.25
2019-09-03,Maine,0,0,1,1,0.5
2019-09-03,North Dakota,0,0,2,2,0.5
2019-09-03,Nebraska,1,1,1,3,0.5
2019-09-03,Maryland,0,0,1,1,0.5
2019-09-03,Kentucky,1,0,0,1,1.0
2019-09-03,Connecticut,1,1,0,2,0.5
2019-09-03,Pennsylvania,0,1,0,1,0.0
2019-09-02,Oregon,0,0,2,2,0.5
2019-09-02,Hawaii,2,2,4,8,0.5
2019-09-02,Alabama,2,6,7,15,0.3666666666666667
2019-09-02,Arkansas,6,3,3,12,0.625
2019-09-02,California,9,5,11,25,0.58
2019-09-02,New York,2,2,3,7,0.5
2019-09-02,Illinois,4,2,6,12,0.5833333333333333
2019-09-02,Maryland,0,1,1,2,0.25
2019-09-02,Michigan,0,0,1,1,0.5
2019-09-02,Pennsylvania,1,0,1,2,0.75
2019-09-02,Massachusetts,3,2,8,13,0.5384615384615385
2019-09-02,Kentucky,0,2,0,2,0.0
2019-09-02,Delaware,0,2,4,6,0.3333333333333333
2019-09-02,Arizona,1,2,1,4,0.375
2019-09-02,Florida,3,0,8,11,0.6363636363636364
2019-09-02,Iowa,1,0,2,3,0.6666666666666666
2019-09-02,Louisiana,2,1,4,7,0.5714285714285714
2019-09-02,Indiana,2,4,3,9,0.38888888888888884
2019-09-02,Georgia,1,2,2,5,0.4
2019-09-02,Texas,1,5,1,7,0.21428571428571427
2019-09-02,Colorado,3,3,3,9,0.5
2019-09-02,Connecticut,0,1,2,3,0.3333333333333333
2019-09-02,Alaska,1,2,0,3,0.3333333333333333
2019-09-02,Kansas,0,1,0,1,0.0
2019-09-02,Missouri,0,0,1,1,0.5
2019-09-02,Washington,1,0,1,2,0.75
2019-09-02,Ohio,1,0,1,2,0.75
2019-09-02,North Carolina,0,1,0,1,0.0
2019-09-02,Nebraska,2,0,0,2,1.0
2019-09-02,Idaho,1,0,0,1,1.0
2019-09-01,Alabama,7,5,9,21,0.5476190476190476
2019-09-01,Nebraska,1,0,1,2,0.75
2019-09-01,Illinois,4,4,6,14,0.5
2019-09-01,Maine,0,0,1,1,0.5
2019-09-01,Arizona,2,1,1,4,0.625
2019-09-01,Florida,5,4,15,24,0.5208333333333334
2019-09-01,Indiana,2,0,6,8,0.625
2019-09-01,Louisiana,4,2,3,9,0.611111111111111
2019-09-01,Arkansas,4,7,6,17,0.4117647058823529
2019-09-01,Hawaii,1,0,2,3,0.6666666666666666
2019-09-01,Colorado,5,3,3,11,0.5909090909090908
2019-09-01,Maryland,0,1,1,2,0.25
2019-09-01,Washington,0,1,1,2,0.25
2019-09-01,Connecticut,0,0,1,1,0.5
2019-09-01,New York,4,3,3,10,0.55
2019-09-01,Iowa,0,2,4,6,0.3333333333333333
2019-09-01,Alaska,1,0,1,2,0.75
2019-09-01,Pennsylvania,0,0,1,1,0.5
2019-09-01,Georgia,1,4,3,8,0.3125
2019-09-01,Idaho,2,0,1,3,0.8333333333333333
2019-09-01,New Jersey,0,1,0,1,0.0
2019-09-01,California,3,7,7,17,0.38235294117647056
2019-09-01,Massachusetts,4,1,4,9,0.6666666666666666
2019-09-01,Missouri,3,1,4,8,0.625
2019-09-01,Utah,0,0,1,1,0.5
2019-09-01,Texas,0,2,2,4,0.25
2019-09-01,Delaware,0,0,1,1,0.5
2019-09-01,Oregon,0,0,1,1,0.5
2019-09-01,North Carolina,0,0,1,1,0.5
2019-09-01,Kansas,0,0,2,2,0.5
2019-09-01,Virginia,1,0,0,1,1.0
2019-08-31,Arkansas,1,3,3,7,0.3571428571428571
2019-08-31,Georgia,3,6,0,9,0.3333333333333333
2019-08-31,Washington,2,2,2,6,0.5
2019-08-31,Alaska,2,1,2,5,0.6000000000000001
2019-08-31,Iowa,0,2,1,3,0.16666666666666666
2019-08-31,Arizona,1,2,1,4,0.375
2019-08-31,California,6,3,4,13,0.6153846153846154
2019-08-31,Florida,2,2,1,5,0.5
2019-08-31,Illinois,1,4,2,7,0.2857142857142857
2019-08-31,Idaho,1,0,1,2,0.75
2019-08-31,New York,3,2,2,7,0.5714285714285714
2019-08-31,Indiana,4,4,3,11,0.5
2019-08-31,Missouri,4,1,1,6,0.75
2019-08-31,Hawaii,1,0,3,4,0.625
2019-08-31,North Carolina,1,0,0,1,1.0
2019-08-31,Alabama,7,2,4,13,0.6923076923076923
2019-08-31,Kansas,0,1,1,2,0.25
2019-08-31,Connecticut,1,1,0,2,0.5
2019-08-31,Colorado,2,1,1,4,0.625
2019-08-31,Massachusetts,2,1,0,3,0.6666666666666666
2019-08-31,Texas,0,0,1,1,0.5
2019-08-31,Louisiana,2,2,1,5,0.5
2019-08-31,Nebraska,2,2,0,4,0.5
2019-08-31,Delaware,1,1,0,2,0.5
2019-08-31,Pennsylvania,0,1,0,1,0.0
2019-08-31,Ohio,0,0,1,1,0.5
2019-08-31,Maryland,0,0,1,1,0.5
2019-08-30,Florida,3,2,3,8,0.5625
2019-08-30,Massachusetts,3,5,10,18,0.4444444444444444
2019-08-30,Arkansas,4,2,8,14,0.5714285714285714
2019-08-30,Maryland,0,3,1,4,0.125
2019-08-30,Indiana,8,4,6,18,0.611111111111111
2019-08-30,Colorado,1,3,4,8,0.375
2019-08-30,Delaware,0,2,2,4,0.25
2019-08-30,Texas,1,1,3,5,0.5
2019-08-30,Ohio,0,0,1,1,0.5
2019-08-30,California,8,9,8,25,0.48
2019-08-30,Georgia,2,1,1,4,0.625
2019-08-30,Alabama,0,7,3,10,0.15
2019-08-30,Illinois,2,1,4,7,0.5714285714285714
2019-08-30,New York,4,1,6,11,0.6363636363636364
2019-08-30,Nebraska,3,1,1,5,0.7
2019-08-30,Louisiana,2,0,2,4,0.75
2019-08-30,Washington,2,2,1,5,0.5
2019-08-30,Arizona,4,0,2,6,0.8333333333333333
2019-08-30,Kentucky,2,0,0,2,1.0
2019-08-30,Hawaii,1,1,1,3,0.5
2019-08-30,Missouri,1,1,2,4,0.5
2019-08-30,Utah,1,0,0,1,1.0
2019-08-30,New Jersey,0,0,1,1,0.5
2019-08-30,Connecticut,0,1,0,1,0.0
2019-08-30,North Carolina,0,1,1,2,0.25
2019-08-30,Kansas,0,0,1,1,0.5
2019-08-30,Iowa,0,0,1,1,0.5
2019-08-30,Oregon,0,0,1,1,0.5
2019-08-30,Michigan,1,0,0,1,1.0
2019-08-30,Maine,0,1,0,1,0.0
2019-08-30,Alaska,2,0,0,2,1.0
2019-08-29,California,14,9,19,42,0.5595238095238095
2019-08-29,Indiana,2,5,8,15,0.4
2019-08-29,Louisiana,1,2,2,5,0.4
2019-08-29,Georgia,0,3,3,6,0.25
2019-08-29,Nebraska,2,2,0,4,0.5
2019-08-29,Maryland,3,1,2,6,0.6666666666666666
2019-08-29,Delaware,2,2,3,7,0.5
2019-08-29,Pennsylvania,0,0,1,1,0.5
2019-08-29,Arkansas,5,3,8,16,0.5625
2019-08-29,Texas,2,1,3,6,0.5833333333333333
2019-08-29,Arizona,4,0,0,4,1.0
2019-08-29,Massachusetts,3,6,3,12,0.375
2019-08-29,Hawaii,1,1,4,6,0.5
2019-08-29,Michigan,1,2,1,4,0.375
2019-08-29,Alaska,1,2,1,4,0.375
2019-08-29,Illinois,2,3,2,7,0.42857142857142855
2019-08-29,Iowa,1,0,1,2,0.75
2019-08-29,New York,0,1,2,3,0.3333333333333333
2019-08-29,Alabama,4,4,6,14,0.5
2019-08-29,Idaho,4,1,0,5,0.8
2019-08-29,Kansas,1,2,2,5,0.4
2019-08-29,Virginia,0,0,1,1,0.5
2019-08-29,Minnesota,1,0,0,1,1.0
2019-08-29,Florida,1,4,1,6,0.25
2019-08-29,Colorado,2,0,1,3,0.8333333333333333
2019-08-29,Maine,1,0,1,2,0.75
2019-08-29,Washington,1,4,0,5,0.2
2019-08-29,Oklahoma,0,0,1,1,0.5
2019-08-29,Tennessee,0,1,0,1,0.0
2019-08-29,Missouri,0,0,1,1,0.5
2019-08-28,California,8,3,16,27,0.5925925925925926
2019-08-28,Florida,7,4,2,13,0.6153846153846154
2019-08-28,Texas,1,1,5,7,0.5
2019-08-28,Massachusetts,8,5,13,26,0.5576923076923077
2019-08-28,Connecticut,0,0,1,1,0.5
2019-08-28,Arkansas,2,5,7,14,0.39285714285714285
2019-08-28,Kansas,1,0,2,3,0.6666666666666666
2019-08-28,North Carolina,0,0,1,1,0.5
2019-08-28,New York,10,2,4,16,0.75
2019-08-28,Hawaii,1,2,4,7,0.42857142857142855
2019-08-28,Indiana,3,5,4,12,0.41666666666666663
2019-08-28,Alaska,1,0,0,1,1.0
2019-08-28,Louisiana,5,2,1,8,0.6875
2019-08-28,Pennsylvania,0,0,1,1,0.5
2019-08-28,Arizona,1,4,3,8,0.3125
2019-08-28,Oregon,0,2,1,3,0.16666666666666666
2019-08-28,Alabama,8,1,4,13,0.7692307692307693
2019-08-28,Nebraska,2,0,1,3,0.8333333333333333
2019-08-28,Iowa,0,1,1,2,0.25
2019-08-28,New Jersey,0,0,2,2,0.5
2019-08-28,Illinois,0,1,3,4,0.375
2019-08-28,Oklahoma,0,1,1,2,0.25
2019-08-28,Colorado,4,1,3,8,0.6875
2019-08-28,Maryland,1,0,1,2,0.75
2019-08-28,Washington,4,0,0,4,1.0
2019-08-28,Georgia,0,2,0,2,0.0
2019-08-28,Virginia,1,0,0,1,1.0
2019-08-28,Ohio,1,1,1,3,0.5
2019-08-28,Idaho,0,1,0,1,0.0
2019-08-28,Michigan,2,0,0,2,1.0
2019-08-28,New Hampshire,1,0,0,1,1.0
2019-08-28,Delaware,0,0,1,1,0.5
2019-08-27,California,6,5,16,27,0.5185185185185185
2019-08-27,Colorado,2,3,5,10,0.45
2019-08-27,New York,2,3,5,10,0.45
2019-08-27,Alabama,2,6,8,16,0.375
2019-08-27,Massachusetts,5,3,2,10,0.6
2019-08-27,Georgia,1,1,1,3,0.5
2019-08-27,Florida,2,4,2,8,0.375
2019-08-27,Kentucky,2,0,1,3,0.8333333333333333
2019-08-27,Indiana,2,4,7,13,0.4230769230769231
2019-08-27,Iowa,0,1,0,1,0.0
2019-08-27,Hawaii,4,4,1,9,0.5
2019-08-27,Arizona,0,6,2,8,0.125
2019-08-27,Alaska,12,0,3,15,0.9
2019-08-27,Nebraska,4,0,2,6,0.8333333333333333
2019-08-27,Arkansas,3,1,8,12,0.5833333333333333
2019-08-27,Delaware,2,2,1,5,0.5
2019-08-27,Louisiana,2,1,5,8,0.5625
2019-08-27,Illinois,1,1,1,3,0.5
2019-08-27,Ohio,0,0,1,1,0.5
2019-08-27,Washington,1,0,1,2,0.75
2019-08-27,Texas,1,1,3,5,0.5
2019-08-27,Michigan,1,0,2,3,0.6666666666666666
2019-08-27,Oregon,2,0,1,3,0.8333333333333333
2019-08-27,North Carolina,0,0,1,1,0.5
2019-08-27,Idaho,0,0,2,2,0.5
2019-08-27,Missouri,1,1,0,2,0.5
2019-08-27,Maryland,1,0,0,1,1.0
2019-08-27,Kansas,0,0,1,1,0.5
2019-08-27,Maine,0,0,1,1,0.5
2019-08-27,Oklahoma,0,1,0,1,0.0
2019-08-27,Pennsylvania,0,1,0,1,0.0
2019-08-27,Montana,1,0,0,1,1.0
2019-08-27,Connecticut,1,0,1,2,0.75
2019-08-26,Washington,5,0,0,5,1.0
2019-08-26,Minnesota,0,0,1,1,0.5
2019-08-26,Maine,1,0,0,1,1.0
2019-08-26,Louisiana,3,3,2,8,0.5
2019-08-26,New York,5,1,5,11,0.6818181818181818
2019-08-26,Alaska,2,2,4,8,0.5
2019-08-26,Texas,0,3,3,6,0.25
2019-08-26,Michigan,1,0,2,3,0.6666666666666666
2019-08-26,Florida,6,1,6,13,0.6923076923076923
2019-08-26,Alabama,2,5,2,9,0.3333333333333333
2019-08-26,Hawaii,2,1,2,5,0.6000000000000001
2019-08-26,Pennsylvania,0,2,4,6,0.3333333333333333
2019-08-26,Georgia,0,2,3,5,0.3
2019-08-26,Colorado,3,0,4,7,0.7142857142857142
2019-08-26,California,9,5,13,27,0.5740740740740741
2019-08-26,Indiana,3,6,5,14,0.39285714285714285
2019-08-26,Missouri,0,1,3,4,0.375
2019-08-26,Arkansas,8,2,6,16,0.6875
2019-08-26,Illinois,1,0,3,4,0.625
2019-08-26,Kansas,2,1,0,3,0.6666666666666666
2019-08-26,Nebraska,1,0,3,4,0.625
2019-08-26,Ohio,0,0,2,2,0.5
2019-08-26,Connecticut,0,0,1,1,0.5
2019-08-26,Massachusetts,7,1,3,11,0.7727272727272727
2019-08-26,Virginia,0,2,2,4,0.25
2019-08-26,Kentucky,0,0,1,1,0.5
2019-08-26,Arizona,1,5,0,6,0.16666666666666666
2019-08-26,Mississippi,0,0,1,1,0.5
2019-08-26,Delaware,1,2,1,4,0.375
2019-08-26,Maryland,0,1,0,1,0.0
2019-08-26,Rhode Island,0,1,0,1,0.0
2019-08-26,Iowa,0,1,1,2,0.25
2019-08-26,Oregon,0,1,0,1,0.0
2019-08-26,New Mexico,0,1,0,1,0.0
2019-08-25,Nebraska,2,2,2,6,0.5
2019-08-25,New York,1,0,2,3,0.6666666666666666
2019-08-25,Indiana,6,1,3,10,0.75
2019-08-25,California,5,3,16,24,0.5416666666666666
2019-08-25,Florida,1,2,3,6,0.41666666666666663
2019-08-25,Connecticut,0,0,2,2,0.5
2019-08-25,Texas,4,2,0,6,0.6666666666666666
2019-08-25,Louisiana,2,3,4,9,0.4444444444444444
2019-08-25,Alabama,3,5,4,12,0.41666666666666663
2019-08-25,Delaware,1,2,1,4,0.375
2019-08-25,Hawaii,0,2,1,3,0.16666666666666666
2019-08-25,Kansas,0,1,1,2,0.25
2019-08-25,Massachusetts,1,3,6,10,0.4
2019-08-25,Pennsylvania,0,0,1,1,0.5
2019-08-25,Alaska,0,0,2,2,0.5
2019-08-25,Arkansas,5,6,2,13,0.46153846153846156
2019-08-25,Arizona,2,1,1,4,0.625
2019-08-25,Maryland,0,1,0,1,0.0
2019-08-25,Georgia,0,1,2,3,0.3333333333333333
2019-08-25,Washington,0,0,1,1,0.5
2019-08-25,Virginia,1,1,0,2,0.5
2019-08-25,Missouri,0,0,1,1,0.5
2019-08-25,Illinois,0,1,1,2,0.25
2019-08-25,Oklahoma,0,0,1,1,0.5
2019-08-25,Colorado,4,1,2,7,0.7142857142857142
2019-08-25,Utah,0,0,1,1,0.5
2019-08-25,Oregon,2,1,0,3,0.6666666666666666
2019-08-25,Maine,1,0,0,1,1.0
2019-08-25,Iowa,0,0,2,2,0.5
2019-08-25,North Carolina,2,0,0,2,1.0
2019-08-25,Idaho,0,1,0,1,0.0
2019-08-25,Minnesota,0,0,1,1,0.5
2019-08-25,West Virginia,0,1,0,1,0.0
2019-08-24,Illinois,1,0,1,2,0.75
2019-08-24,California,9,2,13,24,0.6458333333333333
2019-08-24,Pennsylvania,0,1,1,2,0.25
2019-08-24,Alabama,6,12,3,21,0.3571428571428571
2019-08-24,Arkansas,5,6,8,19,0.47368421052631576
2019-08-24,Colorado,4,1,5,10,0.65
2019-08-24,Indiana,9,2,1,12,0.7916666666666666
2019-08-24,Arizona,2,3,2,7,0.42857142857142855
2019-08-24,Delaware,0,3,5,8,0.3125
2019-08-24,Louisiana,4,2,2,8,0.625
2019-08-24,Alaska,1,2,1,4,0.375
2019-08-24,Kentucky,1,0,1,2,0.75
2019-08-24,Hawaii,2,1,1,4,0.625
2019-08-24,Washington,1,0,2,3,0.6666666666666666
2019-08-24,Oregon,0,5,0,5,0.0
2019-08-24,Maryland,0,0,1,1,0.5
2019-08-24,Florida,2,0,0,2,1.0
2019-08-24,New York,2,1,5,8,0.5625
2019-08-24,Texas,0,3,1,4,0.125
2019-08-24,Georgia,0,0,1,1,0.5
2019-08-24,Massachusetts,1,0,0,1,1.0
2019-08-24,Michigan,0,2,1,3,0.16666666666666666
2019-08-24,Missouri,1,0,1,2,0.75
2019-08-24,Nebraska,0,0,2,2,0.5
2019-08-24,Oklahoma,1,0,0,1,1.0
2019-08-24,West Virginia,0,2,0,2,0.0
2019-08-24,Rhode Island,0,0,1,1,0.5
2019-08-24,New Jersey,0,1,1,2,0.25
2019-08-24,North Carolina,1,0,0,1,1.0
2019-08-23,Alaska,1,2,1,4,0.375
2019-08-23,California,18,12,18,48,0.5625
2019-08-23,Louisiana,3,3,3,9,0.5
2019-08-23,Illinois,5,1,4,10,0.7
2019-08-23,Arkansas,0,5,5,10,0.25
2019-08-23,Missouri,0,0,2,2,0.5
2019-08-23,Arizona,5,6,5,16,0.46875
2019-08-23,Alabama,13,3,10,26,0.6923076923076923
2019-08-23,Colorado,2,2,4,8,0.5
2019-08-23,Delaware,1,2,3,6,0.41666666666666663
2019-08-23,Massachusetts,8,2,4,14,0.7142857142857142
2019-08-23,Washington,3,1,1,5,0.7
2019-08-23,Nebraska,0,3,2,5,0.2
2019-08-23,Hawaii,3,2,1,6,0.5833333333333334
2019-08-23,Maryland,0,1,0,1,0.0
2019-08-23,Pennsylvania,1,2,0,3,0.3333333333333333
2019-08-23,New York,8,4,5,17,0.6176470588235294
2019-08-23,Ohio,0,1,0,1,0.0
2019-08-23,Indiana,3,2,6,11,0.5454545454545454
2019-08-23,Texas,1,3,7,11,0.40909090909090906
2019-08-23,New Jersey,0,0,1,1,0.5
2019-08-23,Florida,3,1,4,8,0.625
2019-08-23,Michigan,0,1,1,2,0.25
2019-08-23,Oregon,0,1,1,2,0.25
2019-08-23,Minnesota,1,0,1,2,0.75
2019-08-23,Virginia,1,0,1,2,0.75
2019-08-23,Iowa,1,0,2,3,0.6666666666666666
2019-08-23,Wisconsin,1,0,0,1,1.0
2019-08-23,Georgia,2,1,1,4,0.625
2019-08-23,Connecticut,0,0,1,1,0.5
2019-08-23,Kansas,0,0,1,1,0.5
2019-08-23,Idaho,0,0,1,1,0.5
2019-08-22,Louisiana,3,6,6,15,0.4
2019-08-22,California,24,17,28,69,0.5507246376811594
2019-08-22,Georgia,7,6,4,17,0.5294117647058824
2019-08-22,Washington,3,2,1,6,0.5833333333333334
2019-08-22,New York,2,2,6,10,0.5
2019-08-22,Ohio,0,0,3,3,0.5
2019-08-22,Arkansas,13,4,10,27,0.6666666666666666
2019-08-22,Alaska,7,2,3,12,0.7083333333333334
2019-08-22,Arizona,4,4,3,11,0.5
2019-08-22,Michigan,1,0,1,2,0.75
2019-08-22,Hawaii,6,1,7,14,0.6785714285714286
2019-08-22,Massachusetts,2,3,4,9,0.4444444444444444
2019-08-22,Texas,5,4,1,10,0.55
2019-08-22,Kentucky,1,0,0,1,1.0
2019-08-22,Delaware,7,0,4,11,0.8181818181818181
2019-08-22,Nebraska,2,1,1,4,0.625
2019-08-22,Alabama,4,12,5,21,0.30952380952380953
2019-08-22,Iowa,5,3,3,11,0.5909090909090908
2019-08-22,Missouri,0,0,1,1,0.5
2019-08-22,North Carolina,0,0,1,1,0.5
2019-08-22,Florida,7,4,3,14,0.6071428571428571
2019-08-22,Illinois,2,6,4,12,0.3333333333333333
2019-08-22,Idaho,2,0,1,3,0.8333333333333333
2019-08-22,Indiana,10,3,10,23,0.6521739130434783
2019-08-22,Colorado,3,7,3,13,0.34615384615384615
2019-08-22,Connecticut,1,3,0,4,0.25
2019-08-22,Nevada,0,0,1,1,0.5
2019-08-22,Utah,3,1,0,4,0.75
2019-08-22,New Mexico,1,0,0,1,1.0
2019-08-22,Oregon,5,2,4,11,0.6363636363636364
2019-08-22,Maryland,1,1,1,3,0.5
2019-08-22,Kansas,0,0,1,1,0.5
2019-08-22,North Dakota,0,2,1,3,0.16666666666666666
2019-08-22,Virginia,0,0,1,1,0.5
2019-08-22,Pennsylvania,0,0,1,1,0.5
2019-08-21,Alaska,0,2,4,6,0.3333333333333333
2019-08-21,California,15,9,19,43,0.5697674418604651
2019-08-21,Arkansas,6,1,7,14,0.6785714285714286
2019-08-21,Colorado,2,2,2,6,0.5
2019-08-21,Nebraska,2,1,3,6,0.5833333333333333
2019-08-21,Iowa,2,1,1,4,0.625
2019-08-21,Hawaii,12,0,5,17,0.8529411764705883
2019-08-21,Florida,5,0,4,9,0.7777777777777778
2019-08-21,Illinois,1,1,3,5,0.5
2019-08-21,Michigan,2,0,1,3,0.8333333333333333
2019-08-21,Ohio,1,0,1,2,0.75
2019-08-21,Arizona,1,2,3,6,0.41666666666666663
2019-08-21,Alabama,3,6,8,17,0.4117647058823529
2019-08-21,Delaware,1,2,1,4,0.375
2019-08-21,New Jersey,0,0,1,1,0.5
2019-08-21,Massachusetts,6,7,5,18,0.4722222222222222
2019-08-21,Connecticut,1,0,1,2,0.75
2019-08-21,Missouri,1,0,1,2,0.75
2019-08-21,Washington,3,2,2,7,0.5714285714285714
2019-08-21,Indiana,4,5,4,13,0.46153846153846156
2019-08-21,Virginia,2,1,0,3,0.6666666666666666
2019-08-21,Texas,2,3,4,9,0.4444444444444444
2019-08-21,Georgia,0,2,2,4,0.25
2019-08-21,New York,4,2,6,12,0.5833333333333333
2019-08-21,Louisiana,1,0,3,4,0.625
2019-08-21,North Carolina,2,0,0,2,1.0
2019-08-21,Oregon,1,0,2,3,0.6666666666666666
2019-08-21,Maine,0,1,0,1,0.0
2019-08-21,Nevada,0,0,1,1,0.5
2019-08-21,Pennsylvania,0,1,0,1,0.0
2019-08-20,Minnesota,1,0,1,2,0.75
2019-08-20,Alaska,7,2,5,14,0.6785714285714286
2019-08-20,Indiana,1,3,5,9,0.3888888888888889
2019-08-20,Louisiana,0,3,2,5,0.2
2019-08-20,Iowa,1,1,3,5,0.5
2019-08-20,Alabama,4,4,5,13,0.5
2019-08-20,Illinois,1,1,3,5,0.5
2019-08-20,Arkansas,2,5,1,8,0.3125
2019-08-20,Georgia,0,2,2,4,0.25
2019-08-20,Massachusetts,2,0,5,7,0.6428571428571428
2019-08-20,New York,4,0,1,5,0.9
2019-08-20,Kansas,0,1,0,1,0.0
2019-08-20,California,10,5,4,19,0.631578947368421
2019-08-20,Texas,4,1,2,7,0.7142857142857142
2019-08-20,Pennsylvania,0,0,2,2,0.5
2019-08-20,North Dakota,0,0,1,1,0.5
2019-08-20,Delaware,2,2,1,5,0.5
2019-08-20,Maryland,1,0,1,2,0.75
2019-08-20,Washington,1,0,1,2,0.75
2019-08-20,Hawaii,0,1,4,5,0.4
2019-08-20,New Mexico,1,0,0,1,1.0
2019-08-20,Florida,3,1,3,7,0.6428571428571428
2019-08-20,Idaho,1,0,0,1,1.0
2019-08-20,Arizona,1,1,2,4,0.5
2019-08-20,Ohio,0,1,2,3,0.3333333333333333
2019-08-20,Connecticut,0,1,0,1,0.0
2019-08-20,Montana,0,1,0,1,0.0
2019-08-20,Colorado,0,0,2,2,0.5
2019-08-20,New Hampshire,1,0,1,2,0.75
2019-08-20,Nebraska,0,1,1,2,0.25
2019-08-20,Oklahoma,0,1,0,1,0.0
2019-08-20,Wisconsin,0,0,1,1,0.5
2019-08-20,Virginia,0,0,1,1,0.5
2019-08-19,Alaska,3,1,3,7,0.6428571428571428
2019-08-19,California,7,8,10,25,0.48000000000000004
2019-08-19,Illinois,0,0,1,1,0.5
2019-08-19,Nebraska,3,3,4,10,0.5
2019-08-19,Tennessee,0,0,2,2,0.5
2019-08-19,Missouri,0,0,3,3,0.5
2019-08-19,Indiana,3,1,3,7,0.6428571428571428
2019-08-19,New York,2,0,2,4,0.75
2019-08-19,Alabama,5,4,6,15,0.5333333333333333
2019-08-19,Florida,3,0,4,7,0.7142857142857142
2019-08-19,Delaware,4,0,1,5,0.9
2019-08-19,Mississippi,0,0,1,1,0.5
2019-08-19,Kentucky,0,0,1,1,0.5
2019-08-19,Texas,1,0,3,4,0.625
2019-08-19,Kansas,0,0,1,1,0.5
2019-08-19,Louisiana,0,1,2,3,0.3333333333333333
2019-08-19,Georgia,0,0,2,2,0.5
2019-08-19,Oklahoma,1,0,0,1,1.0
2019-08-19,Colorado,3,1,0,4,0.75
2019-08-19,Iowa,0,0,1,1,0.5
2019-08-19,Massachusetts,3,0,4,7,0.7142857142857142
2019-08-19,Maryland,0,1,0,1,0.0
2019-08-19,Hawaii,0,1,1,2,0.25
2019-08-19,Arkansas,2,1,1,4,0.625
2019-08-19,Washington,0,2,0,2,0.0
2019-08-19,Ohio,0,0,1,1,0.5
2019-08-19,North Dakota,1,0,0,1,1.0
2019-08-19,Virginia,0,0,1,1,0.5
2019-08-19,Maine,0,1,0,1,0.0
2019-08-19,Michigan,0,0,1,1,0.5
2019-08-19,New Jersey,0,1,0,1,0.0
2019-08-18,California,9,6,13,28,0.5535714285714286
2019-08-18,Georgia,2,1,4,7,0.5714285714285714
2019-08-18,Florida,1,0,2,3,0.6666666666666666
2019-08-18,Indiana,6,2,3,11,0.6818181818181818
2019-08-18,Colorado,2,1,1,4,0.625
2019-08-18,Arkansas,1,3,1,5,0.30000000000000004
2019-08-18,Alabama,0,1,8,9,0.4444444444444444
2019-08-18,Arizona,2,0,2,4,0.75
2019-08-18,Michigan,1,0,1,2,0.75
2019-08-18,Massachusetts,1,1,2,4,0.5
2019-08-18,New Hampshire,0,0,1,1,0.5
2019-08-18,Nebraska,0,1,1,2,0.25
2019-08-18,Louisiana,3,0,1,4,0.875
2019-08-18,Missouri,4,0,0,4,1.0
2019-08-18,Idaho,1,0,2,3,0.6666666666666666
2019-08-18,Washington,0,1,0,1,0.0
2019-08-18,Iowa,0,1,1,2,0.25
2019-08-18,Illinois,1,3,2,6,0.3333333333333333
2019-08-18,New York,1,0,2,3,0.6666666666666666
2019-08-18,Maine,1,0,0,1,1.0
2019-08-18,Connecticut,1,0,0,1,1.0
2019-08-18,Delaware,1,0,3,4,0.625
2019-08-18,Hawaii,1,0,1,2,0.75
2019-08-18,Alaska,2,0,0,2,1.0
2019-08-18,Texas,0,0,2,2,0.5
2019-08-18,Pennsylvania,0,1,0,1,0.0
2019-08-18,Oregon,0,0,2,2,0.5
2019-08-18,North Carolina,1,0,0,1,1.0
2019-08-17,Alaska,0,1,3,4,0.375
2019-08-17,Alabama,5,8,6,19,0.42105263157894735
2019-08-17,Georgia,1,1,2,4,0.5
2019-08-17,Maine,1,1,0,2,0.5
2019-08-17,Iowa,2,1,1,4,0.625
2019-08-17,California,7,3,9,19,0.6052631578947368
2019-08-17,Missouri,1,2,1,4,0.375
2019-08-17,Illinois,1,3,2,6,0.3333333333333333
2019-08-17,Washington,1,1,1,3,0.5
2019-08-17,Massachusetts,2,3,2,7,0.42857142857142855
2019-08-17,Colorado,2,2,0,4,0.5
2019-08-17,Florida,2,3,3,8,0.4375
2019-08-17,Arkansas,3,1,6,10,0.6
2019-08-17,Hawaii,2,0,0,2,1.0
2019-08-17,New York,1,1,1,3,0.5
2019-08-17,Maryland,2,0,1,3,0.8333333333333333
2019-08-17,Wisconsin,0,0,1,1,0.5
2019-08-17,Texas,4,0,4,8,0.75
2019-08-17,Indiana,2,1,0,3,0.6666666666666666
2019-08-17,Oregon,0,1,2,3,0.3333333333333333
2019-08-17,Nebraska,3,1,3,7,0.6428571428571428
2019-08-17,Louisiana,1,1,2,4,0.5
2019-08-17,Arizona,0,2,0,2,0.0
2019-08-17,Delaware,2,1,0,3,0.6666666666666666
2019-08-17,Idaho,0,0,1,1,0.5
2019-08-17,Michigan,1,0,0,1,1.0
2019-08-17,North Dakota,0,0,1,1,0.5
2019-08-16,California,9,4,10,23,0.6086956521739131
2019-08-16,Kansas,0,0,2,2,0.5
2019-08-16,Colorado,4,1,4,9,0.6666666666666666
2019-08-16,Missouri,3,0,3,6,0.75
2019-08-16,Alabama,11,3,9,23,0.6739130434782609
2019-08-16,Arkansas,1,0,10,11,0.5454545454545454
2019-08-16,Alaska,3,2,2,7,0.5714285714285714
2019-08-16,Georgia,3,1,0,4,0.75
2019-08-16,Hawaii,0,2,2,4,0.25
2019-08-16,Florida,5,1,2,8,0.75
2019-08-16,Louisiana,2,0,5,7,0.6428571428571428
2019-08-16,Massachusetts,1,1,8,10,0.5
2019-08-16,New York,3,2,4,9,0.5555555555555556
2019-08-16,Arizona,3,0,1,4,0.875
2019-08-16,Nebraska,0,1,2,3,0.3333333333333333
2019-08-16,Texas,1,3,3,7,0.3571428571428571
2019-08-16,Indiana,5,1,5,11,0.6818181818181818
2019-08-16,Ohio,0,0,1,1,0.5
2019-08-16,Washington,1,1,1,3,0.5
2019-08-16,New Jersey,1,0,0,1,1.0
2019-08-16,Virginia,0,0,1,1,0.5
2019-08-16,Oregon,0,0,1,1,0.5
2019-08-16,Iowa,0,1,1,2,0.25
2019-08-16,Idaho,0,0,2,2,0.5
2019-08-16,Delaware,0,1,0,1,0.0
2019-08-16,Illinois,2,0,0,2,1.0
2019-08-16,Kentucky,0,1,0,1,0.0
2019-08-16,Connecticut,0,0,1,1,0.5
2019-08-16,North Dakota,0,0,1,1,0.5
2019-08-15,California,6,7,14,27,0.48148148148148145
2019-08-15,Arizona,1,0,1,2,0.75
2019-08-15,New York,3,1,2,6,0.6666666666666666
2019-08-15,Illinois,1,1,2,4,0.5
2019-08-15,Alabama,4,3,17,24,0.5208333333333334
2019-08-15,Louisiana,1,1,3,5,0.5
2019-08-15,Oklahoma,0,0,2,2,0.5
2019-08-15,Ohio,0,1,0,1,0.0
2019-08-15,Arkansas,3,4,6,13,0.46153846153846156
2019-08-15,Florida,1,3,4,8,0.375
2019-08-15,Missouri,1,2,3,6,0.41666666666666663
2019-08-15,Pennsylvania,0,0,1,1,0.5
2019-08-15,Alaska,0,1,4,5,0.4
2019-08-15,Massachusetts,5,1,2,8,0.75
2019-08-15,Colorado,3,0,6,9,0.6666666666666666
2019-08-15,Delaware,0,3,1,4,0.125
2019-08-15,Indiana,3,3,6,12,0.5
2019-08-15,Washington,2,0,2,4,0.75
2019-08-15,Texas,3,2,1,6,0.5833333333333334
2019-08-15,Hawaii,4,4,3,11,0.5
2019-08-15,Georgia,3,0,3,6,0.75
2019-08-15,Kansas,0,0,1,1,0.5
2019-08-15,Oregon,0,0,2,2,0.5
2019-08-15,Nebraska,0,1,1,2,0.25
2019-08-15,Idaho,0,1,0,1,0.0
2019-08-15,New Jersey,0,0,1,1,0.5
2019-08-15,Iowa,0,0,1,1,0.5
2019-08-15,Wisconsin,0,0,1,1,0.5
2019-08-15,Michigan,0,0,1,1,0.5
2019-08-14,Arkansas,3,3,2,8,0.5
2019-08-14,Arizona,0,4,2,6,0.16666666666666666
2019-08-14,California,3,1,11,15,0.5666666666666667
2019-08-14,Florida,4,0,1,5,0.9
2019-08-14,Indiana,4,1,4,9,0.6666666666666666
2019-08-14,Hawaii,3,3,2,8,0.5
2019-08-14,Alabama,1,5,6,12,0.3333333333333333
2019-08-14,Pennsylvania,1,0,1,2,0.75
2019-08-14,Michigan,1,1,2,4,0.5
2019-08-14,Texas,0,4,2,6,0.16666666666666666
2019-08-14,Ohio,1,0,2,3,0.6666666666666666
2019-08-14,Louisiana,1,0,1,2,0.75
2019-08-14,Colorado,4,1,2,7,0.7142857142857142
2019-08-14,Minnesota,1,0,0,1,1.0
2019-08-14,Alaska,1,1,5,7,0.5
2019-08-14,Illinois,1,1,5,7,0.5
2019-08-14,New York,4,4,0,8,0.5
2019-08-14,Delaware,2,0,3,5,0.7
2019-08-14,Oklahoma,1,0,0,1,1.0
2019-08-14,Massachusetts,3,1,0,4,0.75
2019-08-14,Georgia,0,1,2,3,0.3333333333333333
2019-08-14,Idaho,2,0,1,3,0.8333333333333333
2019-08-14,Virginia,0,0,1,1,0.5
2019-08-14,Kansas,0,1,0,1,0.0
2019-08-14,Missouri,0,0,1,1,0.5
2019-08-14,Nebraska,0,1,0,1,0.0
2019-08-14,Nevada,0,1,0,1,0.0
2019-08-14,Kentucky,0,0,1,1,0.5
2019-08-14,Oregon,0,0,1,1,0.5
2019-08-14,Connecticut,0,0,1,1,0.5
2019-08-14,Iowa,0,1,0,1,0.0
2019-08-13,Arkansas,2,3,5,10,0.45
2019-08-13,California,9,1,8,18,0.7222222222222222
2019-08-13,Kentucky,0,0,1,1,0.5
2019-08-13,Hawaii,1,3,3,7,0.3571428571428571
2019-08-13,Indiana,5,3,3,11,0.5909090909090908
2019-08-13,Iowa,0,0,2,2,0.5
2019-08-13,Louisiana,1,2,2,5,0.4
2019-08-13,Colorado,0,1,3,4,0.375
2019-08-13,Massachusetts,6,4,1,11,0.5909090909090908
2019-08-13,Missouri,1,1,1,3,0.5
2019-08-13,Idaho,2,1,1,4,0.625
2019-08-13,Alaska,1,1,2,4,0.5
2019-08-13,Alabama,4,7,5,16,0.40625
2019-08-13,New York,3,2,0,5,0.6
2019-08-13,Florida,2,3,2,7,0.42857142857142855
2019-08-13,Nebraska,1,0,3,4,0.625
2019-08-13,Kansas,0,1,2,3,0.3333333333333333
2019-08-13,Arizona,0,1,1,2,0.25
2019-08-13,Pennsylvania,0,0,1,1,0.5
2019-08-13,Washington,1,0,1,2,0.75
2019-08-13,North Dakota,1,0,0,1,1.0
2019-08-13,Nevada,0,0,1,1,0.5
2019-08-13,Texas,1,1,2,4,0.5
2019-08-13,Illinois,4,1,2,7,0.7142857142857142
2019-08-13,Maryland,1,0,0,1,1.0
2019-08-13,Connecticut,1,0,2,3,0.6666666666666666
2019-08-13,Delaware,2,0,2,4,0.75
2019-08-13,Georgia,0,1,2,3,0.3333333333333333
2019-08-13,New Mexico,0,0,1,1,0.5
2019-08-13,Oregon,0,0,1,1,0.5
2019-08-13,Minnesota,1,0,0,1,1.0
2019-08-13,Oklahoma,0,1,0,1,0.0
2019-08-13,Virginia,0,1,0,1,0.0
2019-08-12,California,8,2,5,15,0.7
2019-08-12,Massachusetts,3,2,4,9,0.5555555555555556
2019-08-12,Arkansas,0,2,3,5,0.3
2019-08-12,Alabama,3,7,8,18,0.38888888888888884
2019-08-12,Missouri,0,1,1,2,0.25
2019-08-12,Colorado,2,1,3,6,0.5833333333333333
2019-08-12,Texas,1,2,1,4,0.375
2019-08-12,Kentucky,0,1,1,2,0.25
2019-08-12,Oregon,0,0,2,2,0.5
2019-08-12,Illinois,5,1,2,8,0.75
2019-08-12,Michigan,0,0,2,2,0.5
2019-08-12,Alaska,2,1,1,4,0.625
2019-08-12,Arizona,0,1,0,1,0.0
2019-08-12,Georgia,1,0,6,7,0.5714285714285714
2019-08-12,Indiana,3,4,7,14,0.4642857142857143
2019-08-12,Washington,1,0,1,2,0.75
2019-08-12,Hawaii,0,0,4,4,0.5
2019-08-12,Kansas,0,1,1,2,0.25
2019-08-12,Florida,2,4,1,7,0.3571428571428571
2019-08-12,Nevada,1,0,0,1,1.0
2019-08-12,Nebraska,0,3,0,3,0.0
2019-08-12,Maryland,2,0,1,3,0.8333333333333333
2019-08-12,Louisiana,1,1,0,2,0.5
2019-08-12,Maine,0,0,1,1,0.5
2019-08-12,Iowa,0,2,0,2,0.0
2019-08-12,New York,0,0,2,2,0.5
2019-08-12,West Virginia,0,0,1,1,0.5
2019-08-11,Louisiana,6,2,5,13,0.6538461538461539
2019-08-11,Alabama,2,5,10,17,0.4117647058823529
2019-08-11,California,4,4,2,10,0.5
2019-08-11,Indiana,2,2,0,4,0.5
2019-08-11,Texas,3,3,2,8,0.5
2019-08-11,Delaware,1,2,3,6,0.41666666666666663
2019-08-11,Arkansas,3,3,1,7,0.5
2019-08-11,Minnesota,0,1,1,2,0.25
2019-08-11,Oregon,1,0,2,3,0.6666666666666666
2019-08-11,New York,0,1,0,1,0.0
2019-08-11,Wisconsin,0,0,1,1,0.5
2019-08-11,Illinois,0,1,2,3,0.3333333333333333
2019-08-11,Colorado,1,3,3,7,0.3571428571428571
2019-08-11,South Carolina,1,0,0,1,1.0
2019-08-11,Kansas,0,1,1,2,0.25
2019-08-11,Hawaii,1,0,3,4,0.625
2019-08-11,New Jersey,1,0,0,1,1.0
2019-08-11,Michigan,1,1,0,2,0.5
2019-08-11,Alaska,3,1,2,6,0.6666666666666666
2019-08-11,Massachusetts,2,2,1,5,0.5
2019-08-11,Nebraska,0,1,1,2,0.25
2019-08-11,Arizona,0,1,1,2,0.25
2019-08-11,Idaho,0,1,0,1,0.0
2019-08-11,Georgia,1,2,1,4,0.375
2019-08-11,Florida,2,0,1,3,0.8333333333333333
2019-08-11,Maryland,0,1,0,1,0.0
2019-08-11,New Hampshire,1,0,0,1,1.0
2019-08-11,Pennsylvania,0,0,1,1,0.5
2019-08-11,Iowa,0,1,0,1,0.0
2019-08-10,Michigan,0,2,0,2,0.0
2019-08-10,Arkansas,4,3,2,9,0.5555555555555556
2019-08-10,Alabama,4,1,10,15,0.6
2019-08-10,California,4,3,4,11,0.5454545454545454
2019-08-10,Hawaii,1,2,4,7,0.42857142857142855
2019-08-10,Texas,0,2,2,4,0.25
2019-08-10,Alaska,1,0,2,3,0.6666666666666666
2019-08-10,Idaho,1,0,2,3,0.6666666666666666
2019-08-10,New Jersey,0,0,1,1,0.5
2019-08-10,New Hampshire,0,0,1,1,0.5
2019-08-10,Nevada,0,1,0,1,0.0
2019-08-10,Indiana,1,1,2,4,0.5
2019-08-10,Maryland,1,0,2,3,0.6666666666666666
2019-08-10,Oregon,0,1,3,4,0.375
2019-08-10,Florida,2,1,3,6,0.5833333333333333
2019-08-10,Oklahoma,0,1,0,1,0.0
2019-08-10,Colorado,0,1,3,4,0.375
2019-08-10,Kansas,0,1,0,1,0.0
2019-08-10,New York,3,0,1,4,0.875
2019-08-10,Georgia,0,2,4,6,0.3333333333333333
2019-08-10,Massachusetts,2,0,0,2,1.0
2019-08-10,Pennsylvania,0,0,1,1,0.5
2019-08-10,Louisiana,1,0,1,2,0.75
2019-08-10,Iowa,0,0,4,4,0.5
2019-08-10,Washington,0,0,1,1,0.5
2019-08-10,North Carolina,0,1,0,1,0.0
2019-08-10,Illinois,0,1,2,3,0.3333333333333333
2019-08-10,Mississippi,0,1,0,1,0.0
2019-08-09,Hawaii,1,0,5,6,0.5833333333333334
2019-08-09,Nebraska,1,0,1,2,0.75
2019-08-09,Indiana,2,0,3,5,0.7
2019-08-09,New York,1,1,3,5,0.5
2019-08-09,Alabama,5,3,7,15,0.5666666666666667
2019-08-09,Illinois,1,1,3,5,0.5
2019-08-09,Massachusetts,0,2,7,9,0.3888888888888889
2019-08-09,Oregon,0,0,1,1,0.5
2019-08-09,Arkansas,5,3,4,12,0.5833333333333334
2019-08-09,Delaware,1,1,3,5,0.5
2019-08-09,Colorado,3,0,3,6,0.75
2019-08-09,Georgia,1,1,0,2,0.5
2019-08-09,California,3,2,5,10,0.55
2019-08-09,Florida,2,1,1,4,0.625
2019-08-09,Alaska,0,2,1,3,0.16666666666666666
2019-08-09,Texas,0,0,5,5,0.5
2019-08-09,South Carolina,0,0,1,1,0.5
2019-08-09,Maryland,0,0,1,1,0.5
2019-08-09,Missouri,1,0,1,2,0.75
2019-08-09,Virginia,1,0,0,1,1.0
2019-08-09,Louisiana,0,0,1,1,0.5
2019-08-09,Iowa,1,0,0,1,1.0
2019-08-09,Arizona,1,1,2,4,0.5
2019-08-09,Idaho,2,1,0,3,0.6666666666666666
2019-08-09,Michigan,0,0,1,1,0.5
2019-08-09,Washington,2,0,0,2,1.0
2019-08-08,Alabama,6,3,5,14,0.6071428571428571
2019-08-08,Louisiana,1,3,2,6,0.3333333333333333
2019-08-08,Texas,1,1,2,4,0.5
2019-08-08,Arkansas,4,2,3,9,0.611111111111111
2019-08-08,California,11,5,7,23,0.6304347826086957
2019-08-08,Colorado,2,1,1,4,0.625
2019-08-08,Florida,0,4,4,8,0.25
2019-08-08,Delaware,3,0,3,6,0.75
2019-08-08,Hawaii,1,0,6,7,0.5714285714285714
2019-08-08,Georgia,0,0,2,2,0.5
2019-08-08,Indiana,2,1,5,8,0.5625
2019-08-08,Alaska,0,0,3,3,0.5
2019-08-08,Idaho,1,0,0,1,1.0
2019-08-08,Utah,0,1,0,1,0.0
2019-08-08,New York,1,0,1,2,0.75
2019-08-08,Iowa,1,1,1,3,0.5
2019-08-08,Massachusetts,3,0,1,4,0.875
2019-08-08,Michigan,0,1,0,1,0.0
2019-08-08,New Jersey,0,0,2,2,0.5
2019-08-08,Pennsylvania,1,0,0,1,1.0
2019-08-08,Missouri,0,1,1,2,0.25
2019-08-08,Arizona,0,1,0,1,0.0
2019-08-08,Illinois,2,0,0,2,1.0
2019-08-08,Nebraska,0,1,0,1,0.0
2019-08-07,Alabama,6,3,2,11,0.6363636363636364
2019-08-07,Missouri,1,1,0,2,0.5
2019-08-07,Arkansas,3,3,6,12,0.5
2019-08-07,Indiana,0,5,4,9,0.2222222222222222
2019-08-07,Iowa,0,1,1,2,0.25
2019-08-07,Texas,0,1,2,3,0.3333333333333333
2019-08-07,Hawaii,0,2,1,3,0.16666666666666666
2019-08-07,Illinois,1,1,0,2,0.5
2019-08-07,Idaho,1,0,0,1,1.0
2019-08-07,New York,3,1,2,6,0.6666666666666666
2019-08-07,California,4,2,4,10,0.6000000000000001
2019-08-07,Delaware,1,0,2,3,0.6666666666666666
2019-08-07,Alaska,0,1,2,3,0.3333333333333333
2019-08-07,Georgia,0,0,1,1,0.5
2019-08-07,Colorado,1,0,2,3,0.6666666666666666
2019-08-07,Massachusetts,1,2,2,5,0.4
2019-08-07,Washington,0,0,1,1,0.5
2019-08-07,Florida,0,0,3,3,0.5
2019-08-07,Louisiana,1,0,0,1,1.0
2019-08-07,Nebraska,0,0,1,1,0.5
2019-08-07,Arizona,1,0,0,1,1.0
2019-08-06,Texas,2,1,3,6,0.5833333333333333
2019-08-06,California,4,1,11,16,0.59375
2019-08-06,Alaska,1,2,1,4,0.375
2019-08-06,Alabama,2,1,6,9,0.5555555555555556
2019-08-06,Missouri,0,1,3,4,0.375
2019-08-06,Indiana,2,0,2,4,0.75
2019-08-06,Iowa,2,0,1,3,0.8333333333333333
2019-08-06,Nebraska,0,2,0,2,0.0
2019-08-06,Massachusetts,0,2,3,5,0.3
2019-08-06,Georgia,0,0,4,4,0.5
2019-08-06,Oregon,1,0,0,1,1.0
2019-08-06,Washington,2,1,2,5,0.6000000000000001
2019-08-06,New York,2,1,4,7,0.5714285714285714
2019-08-06,Illinois,1,0,3,4,0.625
2019-08-06,New Hampshire,0,1,1,2,0.25
2019-08-06,Delaware,4,1,1,6,0.75
2019-08-06,Hawaii,1,0,1,2,0.75
2019-08-06,Florida,2,1,0,3,0.6666666666666666
2019-08-06,Arkansas,1,1,1,3,0.5
2019-08-06,Idaho,0,0,2,2,0.5
2019-08-06,Arizona,2,0,1,3,0.8333333333333333
2019-08-06,Colorado,0,0,1,1,0.5
2019-08-06,Virginia,1,0,0,1,1.0
2019-08-06,Connecticut,0,0,1,1,0.5
2019-08-05,New York,0,1,1,2,0.25
2019-08-05,Delaware,1,1,2,4,0.5
2019-08-05,Indiana,6,3,5,14,0.6071428571428571
2019-08-05,Minnesota,1,1,0,2,0.5
2019-08-05,California,5,2,4,11,0.6363636363636364
2019-08-05,Arkansas,2,1,5,8,0.5625
2019-08-05,Alabama,4,4,5,13,0.5
2019-08-05,Washington,2,2,1,5,0.5
2019-08-05,Massachusetts,1,1,3,5,0.5
2019-08-05,Hawaii,0,0,1,1,0.5
2019-08-05,Mississippi,0,1,0,1,0.0
2019-08-05,Nebraska,1,1,0,2,0.5
2019-08-05,Missouri,1,0,1,2,0.75
2019-08-05,Arizona,1,0,0,1,1.0
2019-08-05,Illinois,0,1,1,2,0.25
2019-08-05,Texas,1,0,0,1,1.0
2019-08-05,Louisiana,0,1,0,1,0.0
2019-08-05,Alaska,0,1,0,1,0.0
2019-08-05,Florida,1,1,4,6,0.5
2019-08-05,North Carolina,1,0,0,1,1.0
2019-08-05,Virginia,0,0,1,1,0.5
2019-08-05,Georgia,1,0,0,1,1.0
2019-08-05,Colorado,1,0,0,1,1.0
2019-08-05,Iowa,1,0,0,1,1.0
2019-08-04,California,5,4,8,17,0.5294117647058824
2019-08-04,New York,0,1,2,3,0.3333333333333333
2019-08-04,Florida,0,4,3,7,0.21428571428571427
2019-08-04,Alabama,4,2,5,11,0.5909090909090909
2019-08-04,Nebraska,1,0,1,2,0.75
2019-08-04,Indiana,5,3,6,14,0.5714285714285714
2019-08-04,Georgia,2,2,1,5,0.5
2019-08-04,New Hampshire,1,0,0,1,1.0
2019-08-04,Massachusetts,2,1,2,5,0.6000000000000001
2019-08-04,Kansas,1,2,0,3,0.3333333333333333
2019-08-04,Colorado,2,1,0,3,0.6666666666666666
2019-08-04,Louisiana,1,2,1,4,0.375
2019-08-04,Nevada,0,1,0,1,0.0
2019-08-04,Pennsylvania,0,0,1,1,0.5
2019-08-04,Delaware,1,1,1,3,0.5
2019-08-04,Michigan,1,1,1,3,0.5
2019-08-04,Arkansas,2,1,1,4,0.625
2019-08-04,Oregon,1,1,1,3,0.5
2019-08-04,Hawaii,1,0,1,2,0.75
2019-08-04,Arizona,0,1,0,1,0.0
2019-08-04,Illinois,1,0,1,2,0.75
2019-08-04,Texas,0,0,1,1,0.5
2019-08-04,Ohio,0,1,0,1,0.0
2019-08-04,Idaho,0,0,3,3,0.5
2019-08-04,Oklahoma,0,1,0,1,0.0
2019-08-04,Maryland,0,1,0,1,0.0
2019-08-03,Washington,3,1,2,6,0.6666666666666666
2019-08-03,Florida,2,2,4,8,0.5
2019-08-03,Delaware,2,4,0,6,0.3333333333333333
2019-08-03,Alabama,4,4,6,14,0.5
2019-08-03,California,8,11,8,27,0.4444444444444444
2019-08-03,Indiana,8,3,2,13,0.6923076923076923
2019-08-03,South Carolina,0,1,0,1,0.0
2019-08-03,Illinois,1,3,3,7,0.3571428571428571
2019-08-03,Texas,2,2,1,5,0.5
2019-08-03,Iowa,2,0,2,4,0.75
2019-08-03,Arkansas,2,5,5,12,0.375
2019-08-03,New Jersey,1,0,1,2,0.75
2019-08-03,Colorado,4,3,3,10,0.55
2019-08-03,Georgia,1,2,6,9,0.4444444444444444
2019-08-03,Louisiana,2,0,4,6,0.6666666666666666
2019-08-03,Nebraska,0,2,1,3,0.16666666666666666
2019-08-03,Idaho,0,0,1,1,0.5
2019-08-03,Kansas,1,0,0,1,1.0
2019-08-03,Oregon,2,0,1,3,0.8333333333333333
2019-08-03,Ohio,0,0,1,1,0.5
2019-08-03,Connecticut,1,1,0,2,0.5
2019-08-03,New York,1,0,2,3,0.6666666666666666
2019-08-03,North Carolina,0,1,0,1,0.0
2019-08-03,Hawaii,1,1,1,3,0.5
2019-08-03,Kentucky,0,0,2,2,0.5
2019-08-03,Arizona,2,2,1,5,0.5
2019-08-03,Virginia,0,0,1,1,0.5
2019-08-03,Massachusetts,4,0,4,8,0.75
2019-08-03,Mississippi,0,0,1,1,0.5
2019-08-03,Montana,0,1,0,1,0.0
2019-08-03,Michigan,0,2,1,3,0.16666666666666666
2019-08-03,Pennsylvania,0,0,1,1,0.5
2019-08-03,Alaska,1,0,1,2,0.75
2019-08-03,Maryland,1,0,0,1,1.0
2019-08-02,California,14,4,8,26,0.6923076923076923
2019-08-02,Indiana,6,3,5,14,0.6071428571428571
2019-08-02,Alabama,7,0,11,18,0.6944444444444444
2019-08-02,New York,0,0,1,1,0.5
2019-08-02,Colorado,1,1,4,6,0.5
2019-08-02,Arkansas,3,5,5,13,0.42307692307692313
2019-08-02,Illinois,1,0,3,4,0.625
2019-08-02,Alaska,2,1,2,5,0.6000000000000001
2019-08-02,Nebraska,2,2,1,5,0.5
2019-08-02,Texas,0,3,4,7,0.2857142857142857
2019-08-02,Louisiana,1,4,1,6,0.25
2019-08-02,Massachusetts,4,3,6,13,0.5384615384615385
2019-08-02,Arizona,2,4,1,7,0.3571428571428571
2019-08-02,Georgia,3,0,1,4,0.875
2019-08-02,Delaware,2,1,3,6,0.5833333333333333
2019-08-02,Missouri,4,2,0,6,0.6666666666666666
2019-08-02,Oregon,2,1,0,3,0.6666666666666666
2019-08-02,Ohio,1,1,2,4,0.5
2019-08-02,Florida,4,1,5,10,0.65
2019-08-02,Washington,6,0,1,7,0.9285714285714285
2019-08-02,Maryland,0,0,1,1,0.5
2019-08-02,New Jersey,1,0,1,2,0.75
2019-08-02,Kentucky,0,0,1,1,0.5
2019-08-02,Michigan,1,1,2,4,0.5
2019-08-02,Kansas,0,1,0,1,0.0
2019-08-02,Connecticut,0,0,2,2,0.5
2019-08-02,Hawaii,1,2,0,3,0.3333333333333333
2019-08-02,Maine,0,0,1,1,0.5
2019-08-02,Iowa,1,1,0,2,0.5
2019-08-02,North Carolina,1,0,0,1,1.0
2019-08-02,Minnesota,1,0,0,1,1.0
2019-08-02,New Hampshire,0,0,1,1,0.5
2019-08-02,Pennsylvania,0,0,1,1,0.5
2019-08-01,Alabama,5,4,5,14,0.5357142857142857
2019-08-01,Delaware,3,2,1,6,0.5833333333333334
2019-08-01,Missouri,1,1,0,2,0.5
2019-08-01,Georgia,1,1,0,2,0.5
2019-08-01,Michigan,1,1,1,3,0.5
2019-08-01,Indiana,0,2,3,5,0.3
2019-08-01,California,7,4,13,24,0.5625
2019-08-01,Massachusetts,3,1,2,6,0.6666666666666666
2019-08-01,Iowa,0,1,1,2,0.25
2019-08-01,Arkansas,9,4,4,17,0.6470588235294118
2019-08-01,Florida,1,3,1,5,0.30000000000000004
2019-08-01,Alaska,3,0,1,4,0.875
2019-08-01,Washington,2,1,2,5,0.6000000000000001
2019-08-01,Arizona,2,1,3,6,0.5833333333333333
2019-08-01,Kansas,0,0,2,2,0.5
2019-08-01,New York,2,4,2,8,0.375
2019-08-01,Colorado,13,3,2,18,0.7777777777777778
2019-08-01,Illinois,1,3,4,8,0.375
2019-08-01,Minnesota,1,0,0,1,1.0
2019-08-01,Hawaii,1,2,1,4,0.375
2019-08-01,Louisiana,0,3,2,5,0.2
2019-08-01,Connecticut,0,1,3,4,0.375
2019-08-01,Maine,0,0,1,1,0.5
2019-08-01,Texas,0,4,1,5,0.1
2019-08-01,Idaho,0,1,0,1,0.0
2019-08-01,Nebraska,0,1,3,4,0.375
2019-08-01,West Virginia,0,1,0,1,0.0
2019-08-01,Kentucky,1,0,0,1,1.0
2019-08-01,New Hampshire,1,0,1,2,0.75
2019-08-01,Maryland,1,0,0,1,1.0
2019-08-01,New Jersey,1,0,0,1,1.0
2019-08-01,Oregon,0,0,1,1,0.5
2019-08-01,Utah,0,0,1,1,0.5
2019-07-31,Indiana,3,4,3,10,0.44999999999999996
2019-07-31,California,8,8,8,24,0.5
2019-07-31,Louisiana,2,3,3,8,0.4375
2019-07-31,Washington,2,0,1,3,0.8333333333333333
2019-07-31,Massachusetts,11,3,3,17,0.7352941176470589
2019-07-31,Florida,4,3,9,16,0.53125
2019-07-31,Arkansas,5,7,4,16,0.4375
2019-07-31,New York,7,1,5,13,0.7307692307692307
2019-07-31,New Jersey,1,1,2,4,0.5
2019-07-31,Hawaii,6,3,2,11,0.6363636363636364
2019-07-31,Missouri,0,1,0,1,0.0
2019-07-31,Delaware,5,0,8,13,0.6923076923076923
2019-07-31,Alabama,3,2,3,8,0.5625
2019-07-31,Nebraska,2,0,2,4,0.75
2019-07-31,Georgia,1,4,3,8,0.3125
2019-07-31,Iowa,2,1,2,5,0.6000000000000001
2019-07-31,Colorado,6,4,2,12,0.5833333333333334
2019-07-31,Alaska,0,2,0,2,0.0
2019-07-31,Pennsylvania,0,1,0,1,0.0
2019-07-31,North Carolina,0,0,1,1,0.5
2019-07-31,Nevada,0,0,1,1,0.5
2019-07-31,Virginia,0,0,1,1,0.5
2019-07-31,New Mexico,0,0,1,1,0.5
2019-07-31,Kansas,0,1,1,2,0.25
2019-07-31,Connecticut,0,1,0,1,0.0
2019-07-31,Texas,0,3,1,4,0.125
2019-07-31,Oklahoma,1,0,0,1,1.0
2019-07-31,Mississippi,0,0,1,1,0.5
2019-07-31,Maine,1,1,0,2,0.5
2019-07-31,Maryland,2,0,0,2,1.0
2019-07-31,Minnesota,0,0,1,1,0.5
2019-07-31,Illinois,1,0,0,1,1.0
2019-07-30,Illinois,2,2,4,8,0.5
2019-07-30,Delaware,4,3,8,15,0.5333333333333333
2019-07-30,California,9,6,9,24,0.5625
2019-07-30,Florida,2,0,4,6,0.6666666666666666
2019-07-30,New York,6,4,3,13,0.576923076923077
2019-07-30,Hawaii,4,4,3,11,0.5
2019-07-30,Nebraska,2,3,2,7,0.42857142857142855
2019-07-30,Arkansas,4,4,3,11,0.5
2019-07-30,Alabama,5,3,5,13,0.576923076923077
2019-07-30,Maryland,1,0,1,2,0.75
2019-07-30,Colorado,4,2,1,7,0.6428571428571428
2019-07-30,Massachusetts,4,5,4,13,0.46153846153846156
2019-07-30,Maine,2,0,1,3,0.8333333333333333
2019-07-30,Indiana,3,2,2,7,0.5714285714285714
2019-07-30,Alaska,1,2,1,4,0.375
2019-07-30,New Jersey,2,0,1,3,0.8333333333333333
2019-07-30,Texas,1,1,4,6,0.5
2019-07-30,Michigan,0,2,1,3,0.16666666666666666
2019-07-30,Arizona,1,0,1,2,0.75
2019-07-30,North Carolina,0,2,0,2,0.0
2019-07-30,Minnesota,0,0,2,2,0.5
2019-07-30,Kentucky,0,2,2,4,0.25
2019-07-30,Louisiana,2,1,2,5,0.6000000000000001
2019-07-30,Nevada,0,0,1,1,0.5
2019-07-30,Rhode Island,0,0,1,1,0.5
2019-07-30,Georgia,3,0,2,5,0.8
2019-07-30,Iowa,0,0,1,1,0.5
2019-07-30,Missouri,1,0,0,1,1.0
2019-07-30,Kansas,1,0,0,1,1.0
2019-07-30,Connecticut,0,1,1,2,0.25
2019-07-30,Idaho,1,0,1,2,0.75
2019-07-30,Washington,0,0,1,1,0.5
2019-07-29,Alabama,2,0,5,7,0.6428571428571428
2019-07-29,Hawaii,1,1,3,5,0.5
2019-07-29,Utah,1,0,1,2,0.75
2019-07-29,Texas,2,1,0,3,0.6666666666666666
2019-07-29,Arkansas,2,2,4,8,0.5
2019-07-29,Alaska,2,1,1,4,0.625
2019-07-29,Florida,3,0,2,5,0.8
2019-07-29,California,4,1,4,9,0.6666666666666666
2019-07-29,Colorado,1,1,3,5,0.5
2019-07-29,Massachusetts,6,1,2,9,0.7777777777777777
2019-07-29,Pennsylvania,0,1,0,1,0.0
2019-07-29,Nebraska,0,1,1,2,0.25
2019-07-29,Indiana,5,1,1,7,0.7857142857142857
2019-07-29,Delaware,1,3,1,5,0.30000000000000004
2019-07-29,Arizona,0,0,1,1,0.5
2019-07-29,Missouri,1,0,1,2,0.75
2019-07-29,Washington,0,0,1,1,0.5
2019-07-29,Louisiana,2,0,1,3,0.8333333333333333
2019-07-29,Illinois,2,0,1,3,0.8333333333333333
2019-07-29,Idaho,0,0,1,1,0.5
2019-07-29,Rhode Island,1,0,0,1,1.0
2019-07-29,Georgia,2,0,0,2,1.0
2019-07-29,New York,0,1,1,2,0.25
2019-07-29,North Carolina,1,0,0,1,1.0
2019-07-29,Iowa,0,0,1,1,0.5
2019-07-28,Alabama,2,2,4,8,0.5
2019-07-28,Louisiana,0,1,2,3,0.3333333333333333
2019-07-28,Indiana,1,2,2,5,0.4
2019-07-28,Arkansas,1,2,3,6,0.41666666666666663
2019-07-28,Georgia,1,1,2,4,0.5
2019-07-28,California,6,4,7,17,0.5588235294117647
2019-07-28,Massachusetts,3,2,2,7,0.5714285714285714
2019-07-28,Washington,1,0,1,2,0.75
2019-07-28,Arizona,1,0,0,1,1.0
2019-07-28,New York,3,1,4,8,0.625
2019-07-28,Connecticut,0,0,1,1,0.5
2019-07-28,Alaska,1,0,1,2,0.75
2019-07-28,Texas,1,2,2,5,0.4
2019-07-28,Hawaii,1,1,2,4,0.5
2019-07-28,Illinois,1,1,0,2,0.5
2019-07-28,Iowa,0,2,0,2,0.0
2019-07-28,Florida,0,1,2,3,0.3333333333333333
2019-07-28,Colorado,0,0,1,1,0.5
2019-07-28,Nebraska,0,1,0,1,0.0
2019-07-28,Missouri,1,0,1,2,0.75
2019-07-28,Idaho,0,1,0,1,0.0
2019-07-28,Oregon,1,0,0,1,1.0
2019-07-28,Utah,0,0,1,1,0.5
2019-07-28,Delaware,0,1,0,1,0.0
2019-07-28,Kentucky,0,1,0,1,0.0
2019-07-27,Louisiana,1,0,2,3,0.6666666666666666
2019-07-27,Hawaii,2,3,0,5,0.4
2019-07-27,Alabama,5,2,3,10,0.65
2019-07-27,Colorado,4,2,2,8,0.625
2019-07-27,Indiana,1,1,1,3,0.5
2019-07-27,Arizona,0,4,2,6,0.16666666666666666
2019-07-27,California,6,6,9,21,0.5
2019-07-27,Oregon,2,0,1,3,0.8333333333333333
2019-07-27,Arkansas,3,3,2,8,0.5
2019-07-27,Kansas,0,1,0,1,0.0
2019-07-27,Illinois,1,0,3,4,0.625
2019-07-27,Missouri,2,0,2,4,0.75
2019-07-27,Texas,0,1,2,3,0.3333333333333333
2019-07-27,Massachusetts,0,2,1,3,0.16666666666666666
2019-07-27,New Jersey,0,0,1,1,0.5
2019-07-27,Delaware,1,1,2,4,0.5
2019-07-27,New York,0,0,2,2,0.5
2019-07-27,Florida,0,3,2,5,0.2
2019-07-27,Washington,0,1,0,1,0.0
2019-07-27,Michigan,0,1,1,2,0.25
2019-07-27,Iowa,1,1,0,2,0.5
2019-07-27,Kentucky,1,0,0,1,1.0
2019-07-27,Oklahoma,0,1,0,1,0.0
2019-07-27,Idaho,1,0,1,2,0.75
2019-07-27,Alaska,1,0,1,2,0.75
2019-07-27,Nebraska,0,0,1,1,0.5
2019-07-27,Virginia,0,1,0,1,0.0
2019-07-27,Georgia,0,0,1,1,0.5
2019-07-26,Indiana,2,1,2,5,0.6000000000000001
2019-07-26,Alabama,4,4,6,14,0.5
2019-07-26,California,7,9,9,25,0.46
2019-07-26,Illinois,0,1,1,2,0.25
2019-07-26,Georgia,5,2,4,11,0.6363636363636364
2019-07-26,Iowa,0,0,3,3,0.5
2019-07-26,Arizona,1,0,2,3,0.6666666666666666
2019-07-26,Kentucky,0,0,1,1,0.5
2019-07-26,Florida,2,3,4,9,0.4444444444444444
2019-07-26,Colorado,1,6,1,8,0.1875
2019-07-26,Maryland,0,1,1,2,0.25
2019-07-26,Hawaii,1,0,5,6,0.5833333333333334
2019-07-26,Delaware,3,2,3,8,0.5625
2019-07-26,Alaska,4,1,0,5,0.8
2019-07-26,Missouri,1,0,3,4,0.625
2019-07-26,Ohio,0,1,0,1,0.0
2019-07-26,Pennsylvania,0,0,1,1,0.5
2019-07-26,New York,1,1,0,2,0.5
2019-07-26,Washington,0,1,0,1,0.0
2019-07-26,Massachusetts,1,2,3,6,0.41666666666666663
2019-07-26,Louisiana,0,1,2,3,0.3333333333333333
2019-07-26,Arkansas,2,0,4,6,0.6666666666666666
2019-07-26,Mississippi,0,0,1,1,0.5
2019-07-26,Nevada,1,0,0,1,1.0
2019-07-26,Utah,1,0,0,1,1.0
2019-07-26,Nebraska,2,1,0,3,0.6666666666666666
2019-07-26,Texas,1,0,1,2,0.75
2019-07-26,Idaho,1,0,1,2,0.75
2019-07-26,Minnesota,0,1,0,1,0.0
2019-07-25,Idaho,2,1,0,3,0.6666666666666666
2019-07-25,Alaska,4,1,2,7,0.7142857142857142
2019-07-25,California,6,9,19,34,0.4558823529411765
2019-07-25,Nebraska,2,1,0,3,0.6666666666666666
2019-07-25,Colorado,4,3,4,11,0.5454545454545454
2019-07-25,Arkansas,3,4,12,19,0.47368421052631576
2019-07-25,Washington,0,0,3,3,0.5
2019-07-25,Hawaii,5,2,3,10,0.65
2019-07-25,Louisiana,3,2,2,7,0.5714285714285714
2019-07-25,Oregon,2,1,2,5,0.6000000000000001
2019-07-25,Texas,2,2,3,7,0.5
2019-07-25,Alabama,5,2,6,13,0.6153846153846154
2019-07-25,Iowa,0,2,1,3,0.16666666666666666
2019-07-25,Illinois,1,2,4,7,0.42857142857142855
2019-07-25,Massachusetts,2,3,6,11,0.45454545454545453
2019-07-25,Delaware,3,1,2,6,0.6666666666666666
2019-07-25,Indiana,3,3,8,14,0.5
2019-07-25,Arizona,0,1,2,3,0.3333333333333333
2019-07-25,Pennsylvania,0,0,1,1,0.5
2019-07-25,Georgia,3,1,1,5,0.7
2019-07-25,New Hampshire,1,0,1,2,0.75
2019-07-25,North Dakota,1,1,0,2,0.5
2019-07-25,New Mexico,0,1,1,2,0.25
2019-07-25,Ohio,0,0,2,2,0.5
2019-07-25,Florida,3,1,5,9,0.6111111111111112
2019-07-25,Maine,0,1,1,2,0.25
2019-07-25,New York,3,1,2,6,0.6666666666666666
2019-07-25,New Jersey,0,1,0,1,0.0
2019-07-25,Kentucky,0,1,0,1,0.0
2019-07-25,Michigan,0,0,1,1,0.5
2019-07-25,Kansas,1,0,0,1,1.0
2019-07-24,Alaska,1,0,0,1,1.0
2019-07-24,California,8,2,7,17,0.6764705882352942
2019-07-24,Colorado,2,1,3,6,0.5833333333333333
2019-07-24,Nevada,0,1,0,1,0.0
2019-07-24,Virginia,0,0,1,1,0.5
2019-07-24,Texas,1,0,2,3,0.6666666666666666
2019-07-24,Florida,5,2,0,7,0.7142857142857143
2019-07-24,Arkansas,4,2,5,11,0.5909090909090909
2019-07-24,Hawaii,0,2,2,4,0.25
2019-07-24,Alabama,5,3,4,12,0.5833333333333334
2019-07-24,Arizona,1,1,1,3,0.5
2019-07-24,Delaware,0,0,1,1,0.5
2019-07-24,Louisiana,3,1,2,6,0.6666666666666666
2019-07-24,Indiana,2,2,2,6,0.5
2019-07-24,New York,5,1,1,7,0.7857142857142857
2019-07-24,Nebraska,2,0,0,2,1.0
2019-07-24,Illinois,0,1,3,4,0.375
2019-07-24,Missouri,0,1,4,5,0.4
2019-07-24,Oregon,1,0,0,1,1.0
2019-07-24,North Carolina,0,0,1,1,0.5
2019-07-24,Washington,2,0,1,3,0.8333333333333333
2019-07-24,Massachusetts,0,0,2,2,0.5
2019-07-24,Iowa,0,0,1,1,0.5
2019-07-24,Tennessee,0,0,1,1,0.5
2019-07-24,New Jersey,2,0,0,2,1.0
2019-07-24,Georgia,0,2,0,2,0.0
2019-07-24,Kansas,1,1,0,2,0.5
2019-07-23,Georgia,2,3,3,8,0.4375
2019-07-23,Arkansas,3,4,3,10,0.44999999999999996
2019-07-23,New York,1,2,5,8,0.4375
2019-07-23,Oregon,1,0,1,2,0.75
2019-07-23,Massachusetts,6,2,8,16,0.625
2019-07-23,California,7,5,10,22,0.5454545454545454
2019-07-23,Florida,1,1,7,9,0.5
2019-07-23,Alabama,3,2,7,12,0.5416666666666667
2019-07-23,Indiana,3,1,2,6,0.6666666666666666
2019-07-23,Connecticut,0,1,1,2,0.25
2019-07-23,Delaware,0,0,1,1,0.5
2019-07-23,Illinois,0,0,2,2,0.5
2019-07-23,Washington,2,1,1,4,0.625
2019-07-23,Alaska,0,1,2,3,0.3333333333333333
2019-07-23,Colorado,0,1,4,5,0.4
2019-07-23,Louisiana,2,0,1,3,0.8333333333333333
2019-07-23,Hawaii,2,0,3,5,0.7
2019-07-23,Idaho,2,0,1,3,0.8333333333333333
2019-07-23,New Jersey,0,0,2,2,0.5
2019-07-23,Minnesota,1,0,0,1,1.0
2019-07-23,Texas,0,2,1,3,0.16666666666666666
2019-07-23,Virginia,0,0,1,1,0.5
2019-07-23,New Hampshire,1,0,0,1,1.0
2019-07-23,Pennsylvania,0,1,0,1,0.0
2019-07-23,Nebraska,1,1,2,4,0.5
2019-07-23,Michigan,1,2,0,3,0.3333333333333333
2019-07-23,Oklahoma,0,0,1,1,0.5
2019-07-23,Missouri,1,0,1,2,0.75
2019-07-23,Kentucky,2,0,0,2,1.0
2019-07-22,Arkansas,2,3,3,8,0.4375
2019-07-22,New York,1,2,3,6,0.41666666666666663
2019-07-22,Washington,5,1,1,7,0.7857142857142857
2019-07-22,Nebraska,1,2,1,4,0.375
2019-07-22,California,4,6,4,14,0.42857142857142855
2019-07-22,Indiana,2,0,4,6,0.6666666666666666
2019-07-22,Delaware,1,1,3,5,0.5
2019-07-22,Alabama,3,1,8,12,0.5833333333333333
2019-07-22,Massachusetts,0,6,5,11,0.22727272727272727
2019-07-22,Michigan,1,0,1,2,0.75
2019-07-22,Colorado,3,0,0,3,1.0
2019-07-22,New Jersey,0,0,1,1,0.5
2019-07-22,Alaska,0,0,3,3,0.5
2019-07-22,Texas,0,2,2,4,0.25
2019-07-22,Florida,0,1,2,3,0.3333333333333333
2019-07-22,Kentucky,1,1,2,4,0.5
2019-07-22,Missouri,0,1,1,2,0.25
2019-07-22,Illinois,1,0,2,3,0.6666666666666666
2019-07-22,Iowa,0,1,0,1,0.0
2019-07-22,Georgia,1,0,5,6,0.5833333333333334
2019-07-22,Louisiana,4,0,1,5,0.9
2019-07-22,Hawaii,1,0,2,3,0.6666666666666666
2019-07-22,Pennsylvania,0,0,3,3,0.5
2019-07-21,Louisiana,5,0,7,12,0.7083333333333334
2019-07-21,Iowa,2,1,1,4,0.625
2019-07-21,Kentucky,1,2,0,3,0.3333333333333333
2019-07-21,Massachusetts,7,2,6,15,0.6666666666666667
2019-07-21,Colorado,1,2,1,4,0.375
2019-07-21,New York,0,2,3,5,0.3
2019-07-21,Texas,1,0,1,2,0.75
2019-07-21,California,6,7,5,18,0.4722222222222222
2019-07-21,Missouri,1,2,0,3,0.3333333333333333
2019-07-21,Alabama,6,3,5,14,0.6071428571428571
2019-07-21,Indiana,3,1,3,7,0.6428571428571428
2019-07-21,Illinois,0,3,3,6,0.25
2019-07-21,Georgia,0,0,2,2,0.5
2019-07-21,Florida,0,2,3,5,0.3
2019-07-21,Maryland,1,2,0,3,0.3333333333333333
2019-07-21,New Hampshire,0,0,1,1,0.5
2019-07-21,Arkansas,3,2,5,10,0.55
2019-07-21,Hawaii,1,0,3,4,0.625
2019-07-21,Arizona,1,1,0,2,0.5
2019-07-21,Alaska,2,0,3,5,0.7
2019-07-21,Nebraska,1,0,1,2,0.75
2019-07-21,Virginia,0,1,0,1,0.0
2019-07-21,Kansas,0,1,0,1,0.0
2019-07-21,Oregon,0,0,2,2,0.5
2019-07-21,New Jersey,0,1,0,1,0.0
2019-07-21,Michigan,0,0,2,2,0.5
2019-07-21,Delaware,1,0,1,2,0.75
2019-07-21,Maine,0,0,1,1,0.5
2019-07-21,Connecticut,0,1,0,1,0.0
2019-07-21,Washington,0,0,2,2,0.5
2019-07-21,Ohio,0,0,1,1,0.5
2019-07-20,Indiana,3,1,9,13,0.5769230769230769
2019-07-20,New York,1,4,4,9,0.3333333333333333
2019-07-20,Massachusetts,2,3,4,9,0.4444444444444444
2019-07-20,Florida,0,2,6,8,0.375
2019-07-20,Illinois,0,5,6,11,0.2727272727272727
2019-07-20,California,5,2,12,19,0.5789473684210527
2019-07-20,Colorado,4,3,5,12,0.5416666666666666
2019-07-20,Maine,0,1,0,1,0.0
2019-07-20,Arkansas,2,6,9,17,0.38235294117647056
2019-07-20,Texas,0,4,1,5,0.1
2019-07-20,Oregon,0,1,2,3,0.3333333333333333
2019-07-20,Alaska,2,2,1,5,0.5
2019-07-20,Georgia,2,1,4,7,0.5714285714285714
2019-07-20,Alabama,3,2,6,11,0.5454545454545454
2019-07-20,Delaware,0,1,5,6,0.4166666666666667
2019-07-20,Nebraska,0,0,1,1,0.5
2019-07-20,Louisiana,1,0,1,2,0.75
2019-07-20,Hawaii,1,0,4,5,0.6000000000000001
2019-07-20,New Jersey,0,1,1,2,0.25
2019-07-20,Kentucky,0,1,1,2,0.25
2019-07-20,Iowa,1,1,1,3,0.5
2019-07-20,Virginia,0,0,1,1,0.5
2019-07-20,Missouri,0,1,1,2,0.25
2019-07-20,Kansas,0,0,1,1,0.5
2019-07-20,Utah,0,0,2,2,0.5
2019-07-20,Michigan,0,0,1,1,0.5
2019-07-20,Minnesota,0,1,0,1,0.0
2019-07-20,North Carolina,0,0,1,1,0.5
2019-07-20,Pennsylvania,0,0,2,2,0.5
2019-07-19,Delaware,0,2,5,7,0.35714285714285715
2019-07-19,Colorado,5,1,4,10,0.7
2019-07-19,Nebraska,1,1,4,6,0.5
2019-07-19,Illinois,3,1,5,9,0.6111111111111112
2019-07-19,California,6,5,9,20,0.525
2019-07-19,Alabama,4,2,8,14,0.5714285714285714
2019-07-19,Texas,2,2,3,7,0.5
2019-07-19,Florida,3,1,4,8,0.625
2019-07-19,Louisiana,4,2,3,9,0.611111111111111
2019-07-19,Indiana,3,2,9,14,0.5357142857142857
2019-07-19,New York,1,3,3,7,0.3571428571428571
2019-07-19,Washington,2,2,1,5,0.5
2019-07-19,Arkansas,3,0,8,11,0.6363636363636364
2019-07-19,North Carolina,1,0,0,1,1.0
2019-07-19,Massachusetts,3,2,6,11,0.5454545454545454
2019-07-19,Missouri,0,2,0,2,0.0
2019-07-19,Hawaii,1,1,3,5,0.5
2019-07-19,Georgia,2,2,0,4,0.5
2019-07-19,Alaska,0,1,3,4,0.375
2019-07-19,Pennsylvania,1,1,2,4,0.5
2019-07-19,Oregon,2,1,1,4,0.625
2019-07-19,Iowa,0,3,3,6,0.25
2019-07-19,Arizona,1,3,0,4,0.25
2019-07-19,Ohio,0,0,2,2,0.5
2019-07-19,Utah,0,0,1,1,0.5
2019-07-19,Montana,0,1,0,1,0.0
2019-07-19,Maine,0,0,1,1,0.5
2019-07-19,New Jersey,0,0,1,1,0.5
2019-07-19,Minnesota,1,0,0,1,1.0
2019-07-19,Oklahoma,1,0,0,1,1.0
2019-07-19,Maryland,0,2,1,3,0.16666666666666666
2019-07-19,South Carolina,0,1,0,1,0.0
2019-07-18,Colorado,8,1,3,12,0.7916666666666666
2019-07-18,Indiana,2,2,3,7,0.5
2019-07-18,Minnesota,0,0,1,1,0.5
2019-07-18,Ohio,0,0,1,1,0.5
2019-07-18,Iowa,1,0,2,3,0.6666666666666666
2019-07-18,Alabama,6,1,6,13,0.6923076923076923
2019-07-18,Illinois,3,0,2,5,0.8
2019-07-18,California,10,3,10,23,0.6521739130434783
2019-07-18,Hawaii,3,1,1,5,0.7
2019-07-18,Washington,0,0,1,1,0.5
2019-07-18,Connecticut,0,0,1,1,0.5
2019-07-18,Delaware,1,0,2,3,0.6666666666666666
2019-07-18,Texas,0,3,2,5,0.2
2019-07-18,Georgia,0,1,4,5,0.4
2019-07-18,Louisiana,4,1,1,6,0.75
2019-07-18,Virginia,0,1,0,1,0.0
2019-07-18,New York,0,0,3,3,0.5
2019-07-18,South Carolina,1,0,1,2,0.75
2019-07-18,Massachusetts,2,3,1,6,0.41666666666666663
2019-07-18,Missouri,0,2,0,2,0.0
2019-07-18,Maine,0,1,0,1,0.0
2019-07-18,Florida,1,2,1,4,0.375
2019-07-18,Oregon,0,0,3,3,0.5
2019-07-18,Kentucky,0,0,1,1,0.5
2019-07-18,Pennsylvania,0,0,1,1,0.5
2019-07-18,North Dakota,1,0,0,1,1.0
2019-07-18,Idaho,1,0,0,1,1.0
2019-07-18,Arkansas,2,3,1,6,0.41666666666666663
2019-07-18,Kansas,0,1,0,1,0.0
2019-07-18,Maryland,0,1,0,1,0.0
2019-07-18,Nebraska,0,0,2,2,0.5
2019-07-18,Michigan,0,0,1,1,0.5
2019-07-18,Alaska,0,1,0,1,0.0
2019-07-17,California,8,3,7,18,0.6388888888888888
2019-07-17,Alabama,3,4,10,17,0.47058823529411764
2019-07-17,Massachusetts,3,4,6,13,0.46153846153846156
2019-07-17,Nevada,0,1,0,1,0.0
2019-07-17,Alaska,2,2,0,4,0.5
2019-07-17,Washington,2,1,0,3,0.6666666666666666
2019-07-17,Minnesota,0,0,1,1,0.5
2019-07-17,Nebraska,1,1,2,4,0.5
2019-07-17,Arkansas,1,1,7,9,0.5
2019-07-17,New York,1,1,3,5,0.5
2019-07-17,Hawaii,6,2,4,12,0.6666666666666666
2019-07-17,Illinois,1,2,0,3,0.3333333333333333
2019-07-17,Arizona,0,3,1,4,0.125
2019-07-17,Missouri,0,2,0,2,0.0
2019-07-17,Indiana,3,2,5,10,0.55
2019-07-17,Texas,1,1,0,2,0.5
2019-07-17,New Jersey,0,1,0,1,0.0
2019-07-17,Colorado,4,2,4,10,0.6000000000000001
2019-07-17,Florida,2,2,2,6,0.5
2019-07-17,Maryland,0,0,1,1,0.5
2019-07-17,Delaware,0,0,2,2,0.5
2019-07-17,Georgia,1,1,2,4,0.5
2019-07-17,Iowa,0,1,0,1,0.0
2019-07-17,Louisiana,1,0,1,2,0.75
2019-07-17,North Carolina,1,0,0,1,1.0
2019-07-17,Pennsylvania,1,0,0,1,1.0
2019-07-17,Michigan,0,1,0,1,0.0
2019-07-17,Idaho,0,0,1,1,0.5
2019-07-16,California,8,5,7,20,0.575
2019-07-16,Iowa,0,0,1,1,0.5
2019-07-16,Delaware,0,3,2,5,0.2
2019-07-16,Arkansas,3,3,2,8,0.5
2019-07-16,Alaska,1,2,0,3,0.3333333333333333
2019-07-16,Texas,1,0,1,2,0.75
2019-07-16,Maine,0,0,1,1,0.5
2019-07-16,Colorado,2,0,3,5,0.7
2019-07-16,Hawaii,4,2,3,9,0.611111111111111
2019-07-16,Washington,2,0,0,2,1.0
2019-07-16,Georgia,0,0,1,1,0.5
2019-07-16,Indiana,3,2,2,7,0.5714285714285714
2019-07-16,Arizona,0,1,2,3,0.3333333333333333
2019-07-16,Idaho,0,0,1,1,0.5
2019-07-16,Minnesota,1,0,0,1,1.0
2019-07-16,Massachusetts,3,3,7,13,0.5
2019-07-16,Kansas,0,1,0,1,0.0
2019-07-16,Louisiana,0,0,2,2,0.5
2019-07-16,Alabama,3,0,5,8,0.6875
2019-07-16,Kentucky,0,0,1,1,0.5
2019-07-16,New York,0,1,3,4,0.375
2019-07-16,Illinois,0,2,2,4,0.25
2019-07-16,Nebraska,4,0,0,4,1.0
2019-07-16,Missouri,2,0,0,2,1.0
2019-07-16,Pennsylvania,0,0,1,1,0.5
2019-07-16,Florida,0,0,1,1,0.5
2019-07-16,New Jersey,1,0,0,1,1.0
2019-07-15,Georgia,0,0,2,2,0.5
2019-07-15,Delaware,0,0,2,2,0.5
2019-07-15,Indiana,3,1,3,7,0.6428571428571428
2019-07-15,Arkansas,1,1,7,9,0.5
2019-07-15,Colorado,0,4,1,5,0.1
2019-07-15,Hawaii,9,0,4,13,0.8461538461538461
2019-07-15,Alabama,1,3,0,4,0.25
2019-07-15,California,7,1,7,15,0.7
2019-07-15,Pennsylvania,0,1,0,1,0.0
2019-07-15,Iowa,1,0,1,2,0.75
2019-07-15,Illinois,0,1,1,2,0.25
2019-07-15,New Mexico,0,0,1,1,0.5
2019-07-15,Nevada,0,0,2,2,0.5
2019-07-15,Louisiana,0,1,1,2,0.25
2019-07-15,Florida,0,1,2,3,0.3333333333333333
2019-07-15,Washington,1,0,1,2,0.75
2019-07-15,Ohio,0,0,2,2,0.5
2019-07-15,Texas,1,3,0,4,0.25
2019-07-15,Massachusetts,3,0,4,7,0.7142857142857142
2019-07-15,Oregon,5,0,0,5,1.0
2019-07-15,Alaska,1,0,1,2,0.75
2019-07-15,Idaho,0,1,1,2,0.25
2019-07-15,Oklahoma,0,0,1,1,0.5
2019-07-15,Michigan,0,1,0,1,0.0
2019-07-14,Colorado,2,0,2,4,0.75
2019-07-14,New York,1,1,4,6,0.5
2019-07-14,Arkansas,1,2,5,8,0.4375
2019-07-14,Florida,1,1,1,3,0.5
2019-07-14,California,9,5,7,21,0.5952380952380952
2019-07-14,Indiana,3,2,5,10,0.55
2019-07-14,Georgia,5,1,2,8,0.75
2019-07-14,Massachusetts,2,0,3,5,0.7
2019-07-14,Kansas,0,1,0,1,0.0
2019-07-14,Oregon,2,1,0,3,0.6666666666666666
2019-07-14,Connecticut,1,0,1,2,0.75
2019-07-14,Alabama,1,6,4,11,0.2727272727272727
2019-07-14,Pennsylvania,0,1,1,2,0.25
2019-07-14,Texas,1,2,1,4,0.375
2019-07-14,Illinois,1,1,1,3,0.5
2019-07-14,Nebraska,0,1,2,3,0.3333333333333333
2019-07-14,Arizona,0,1,0,1,0.0
2019-07-14,Louisiana,1,1,2,4,0.5
2019-07-14,Idaho,1,0,0,1,1.0
2019-07-14,Missouri,1,2,0,3,0.3333333333333333
2019-07-14,Michigan,0,1,0,1,0.0
2019-07-14,Hawaii,1,2,0,3,0.3333333333333333
2019-07-14,New Jersey,2,0,1,3,0.8333333333333333
2019-07-14,Alaska,0,0,2,2,0.5
2019-07-14,Ohio,0,1,0,1,0.0
2019-07-14,Delaware,0,1,0,1,0.0
2019-07-14,Iowa,1,0,1,2,0.75
2019-07-13,Idaho,1,0,1,2,0.75
2019-07-13,Hawaii,1,1,4,6,0.5
2019-07-13,Florida,3,2,3,8,0.5625
2019-07-13,Delaware,3,0,2,5,0.8
2019-07-13,California,8,2,8,18,0.6666666666666666
2019-07-13,New Jersey,1,0,0,1,1.0
2019-07-13,Louisiana,1,1,5,7,0.5
2019-07-13,Nebraska,0,1,2,3,0.3333333333333333
2019-07-13,Georgia,1,0,2,3,0.6666666666666666
2019-07-13,Illinois,1,1,3,5,0.5
2019-07-13,Arizona,0,0,2,2,0.5
2019-07-13,Massachusetts,1,2,3,6,0.41666666666666663
2019-07-13,Arkansas,2,0,0,2,1.0
2019-07-13,Alabama,2,1,1,4,0.625
2019-07-13,Alaska,0,1,1,2,0.25
2019-07-13,Ohio,1,0,0,1,1.0
2019-07-13,Texas,1,2,1,4,0.375
2019-07-13,Oregon,1,0,0,1,1.0
2019-07-13,Colorado,0,0,1,1,0.5
2019-07-13,New York,2,0,1,3,0.8333333333333333
2019-07-13,Indiana,1,0,2,3,0.6666666666666666
2019-07-13,North Carolina,0,0,1,1,0.5
2019-07-13,South Carolina,0,1,0,1,0.0
2019-07-13,Missouri,3,0,1,4,0.875
2019-07-13,Washington,3,0,0,3,1.0
2019-07-13,Pennsylvania,0,0,1,1,0.5
2019-07-12,Arkansas,3,1,2,6,0.6666666666666666
2019-07-12,Indiana,2,4,2,8,0.375
2019-07-12,Massachusetts,5,0,5,10,0.75
2019-07-12,California,5,1,4,10,0.7
2019-07-12,Idaho,1,1,2,4,0.5
2019-07-12,Colorado,1,3,3,7,0.3571428571428571
2019-07-12,Arizona,0,1,2,3,0.3333333333333333
2019-07-12,Michigan,1,0,0,1,1.0
2019-07-12,Hawaii,3,2,1,6,0.5833333333333334
2019-07-12,New York,1,1,2,4,0.5
2019-07-12,Connecticut,0,1,0,1,0.0
2019-07-12,Alabama,1,0,4,5,0.6000000000000001
2019-07-12,Pennsylvania,0,1,0,1,0.0
2019-07-12,Georgia,1,0,2,3,0.6666666666666666
2019-07-12,Nebraska,2,2,2,6,0.5
2019-07-12,Louisiana,0,1,1,2,0.25
2019-07-12,Florida,0,2,1,3,0.16666666666666666
2019-07-12,Delaware,0,1,1,2,0.25
2019-07-12,Virginia,0,1,0,1,0.0
2019-07-12,Alaska,2,0,0,2,1.0
2019-07-12,Illinois,2,0,1,3,0.8333333333333333
2019-07-12,Missouri,0,0,1,1,0.5
2019-07-12,Texas,1,1,0,2,0.5
2019-07-12,Iowa,0,0,1,1,0.5
2019-07-12,Washington,0,0,1,1,0.5
2019-07-12,Ohio,1,0,0,1,1.0
2019-07-11,Indiana,4,1,3,8,0.6875
2019-07-11,Arizona,0,1,2,3,0.3333333333333333
2019-07-11,New Jersey,0,0,2,2,0.5
2019-07-11,Texas,0,0,2,2,0.5
2019-07-11,Alabama,4,4,4,12,0.5
2019-07-11,California,8,7,6,21,0.5238095238095237
2019-07-11,Ohio,1,0,1,2,0.75
2019-07-11,Florida,2,1,4,7,0.5714285714285714
2019-07-11,Illinois,3,2,4,9,0.5555555555555556
2019-07-11,Hawaii,4,0,4,8,0.75
2019-07-11,Nebraska,2,0,1,3,0.8333333333333333
2019-07-11,Arkansas,4,3,5,12,0.5416666666666666
2019-07-11,Georgia,1,0,1,2,0.75
2019-07-11,Tennessee,0,0,1,1,0.5
2019-07-11,Iowa,1,2,1,4,0.375
2019-07-11,Kansas,1,1,1,3,0.5
2019-07-11,Missouri,0,1,1,2,0.25
2019-07-11,New York,0,1,3,4,0.375
2019-07-11,Michigan,1,1,2,4,0.5
2019-07-11,Washington,1,0,1,2,0.75
2019-07-11,Massachusetts,3,2,1,6,0.5833333333333334
2019-07-11,Louisiana,1,1,0,2,0.5
2019-07-11,Delaware,1,4,3,8,0.3125
2019-07-11,Colorado,1,0,1,2,0.75
2019-07-11,North Carolina,1,0,1,2,0.75
2019-07-11,Alaska,1,0,1,2,0.75
2019-07-11,Kentucky,0,0,1,1,0.5
2019-07-11,Oregon,0,1,0,1,0.0
2019-07-11,Idaho,0,0,1,1,0.5
2019-07-10,Louisiana,2,3,2,7,0.42857142857142855
2019-07-10,California,9,7,8,24,0.5416666666666666
2019-07-10,Indiana,3,2,5,10,0.55
2019-07-10,Delaware,1,1,1,3,0.5
2019-07-10,Colorado,1,1,6,8,0.5
2019-07-10,Kentucky,0,1,1,2,0.25
2019-07-10,Alabama,6,2,5,13,0.6538461538461539
2019-07-10,Florida,0,1,3,4,0.375
2019-07-10,Connecticut,1,0,0,1,1.0
2019-07-10,Nebraska,0,2,3,5,0.3
2019-07-10,Kansas,0,0,1,1,0.5
2019-07-10,Washington,0,0,1,1,0.5
2019-07-10,Alaska,3,3,2,8,0.5
2019-07-10,Hawaii,2,4,1,7,0.3571428571428571
2019-07-10,Illinois,0,1,2,3,0.3333333333333333
2019-07-10,Arkansas,2,2,4,8,0.5
2019-07-10,Massachusetts,1,4,4,9,0.3333333333333333
2019-07-10,New York,0,2,2,4,0.25
2019-07-10,Pennsylvania,1,0,0,1,1.0
2019-07-10,Georgia,0,1,5,6,0.4166666666666667
2019-07-10,New Jersey,0,1,0,1,0.0
2019-07-10,Maryland,2,0,0,2,1.0
2019-07-10,Maine,2,0,0,2,1.0
2019-07-10,Arizona,1,1,1,3,0.5
2019-07-10,Minnesota,0,0,1,1,0.5
2019-07-10,Oregon,0,1,0,1,0.0
2019-07-10,Iowa,0,1,1,2,0.25
2019-07-10,Missouri,0,1,0,1,0.0
2019-07-10,Texas,0,1,1,2,0.25
2019-07-10,Idaho,2,0,0,2,1.0
2019-07-10,Virginia,0,0,2,2,0.5
2019-07-09,Alabama,5,3,2,10,0.6
2019-07-09,California,11,6,20,37,0.5675675675675675
2019-07-09,Nebraska,4,4,1,9,0.5
2019-07-09,Colorado,0,3,1,4,0.125
2019-07-09,Arkansas,4,3,2,9,0.5555555555555556
2019-07-09,Georgia,1,2,1,4,0.375
2019-07-09,Florida,0,2,4,6,0.3333333333333333
2019-07-09,Indiana,3,3,2,8,0.5
2019-07-09,Hawaii,2,4,7,13,0.4230769230769231
2019-07-09,Texas,0,3,4,7,0.2857142857142857
2019-07-09,Arizona,2,1,0,3,0.6666666666666666
2019-07-09,Delaware,2,0,1,3,0.8333333333333333
2019-07-09,Massachusetts,2,2,1,5,0.5
2019-07-09,Iowa,1,0,1,2,0.75
2019-07-09,Illinois,0,1,2,3,0.3333333333333333
2019-07-09,Nevada,0,0,1,1,0.5
2019-07-09,Missouri,0,1,2,3,0.3333333333333333
2019-07-09,Louisiana,2,1,2,5,0.6000000000000001
2019-07-09,Virginia,0,0,1,1,0.5
2019-07-09,New Jersey,0,1,0,1,0.0
2019-07-09,Idaho,3,0,0,3,1.0
2019-07-09,Alaska,3,0,2,5,0.8
2019-07-09,Minnesota,1,0,0,1,1.0
2019-07-09,Kentucky,0,1,0,1,0.0
2019-07-09,Tennessee,0,0,1,1,0.5
2019-07-09,Michigan,0,0,1,1,0.5
2019-07-08,Louisiana,6,2,2,10,0.7
2019-07-08,California,13,5,9,27,0.6481481481481481
2019-07-08,Florida,2,2,4,8,0.5
2019-07-08,Indiana,4,1,2,7,0.7142857142857142
2019-07-08,Arizona,2,0,0,2,1.0
2019-07-08,Colorado,5,3,0,8,0.625
2019-07-08,Maine,1,0,0,1,1.0
2019-07-08,Delaware,2,0,1,3,0.8333333333333333
2019-07-08,Kansas,0,0,1,1,0.5
2019-07-08,Pennsylvania,0,0,2,2,0.5
2019-07-08,Massachusetts,4,2,2,8,0.625
2019-07-08,Iowa,0,0,3,3,0.5
2019-07-08,Alaska,1,1,3,5,0.5
2019-07-08,Georgia,3,2,2,7,0.5714285714285714
2019-07-08,Arkansas,2,4,5,11,0.40909090909090906
2019-07-08,Alabama,3,2,3,8,0.5625
2019-07-08,Illinois,2,1,2,5,0.6000000000000001
2019-07-08,Idaho,1,0,0,1,1.0
2019-07-08,Texas,1,0,2,3,0.6666666666666666
2019-07-08,Oregon,0,1,0,1,0.0
2019-07-08,New York,1,1,2,4,0.5
2019-07-08,Kentucky,1,0,0,1,1.0
2019-07-08,Maryland,1,1,0,2,0.5
2019-07-08,Michigan,0,0,2,2,0.5
2019-07-08,Nebraska,0,1,1,2,0.25
2019-07-08,Hawaii,2,0,1,3,0.8333333333333333
2019-07-08,Connecticut,1,1,1,3,0.5
2019-07-08,Washington,0,0,1,1,0.5
2019-07-07,Alabama,5,2,12,19,0.5789473684210527
2019-07-07,Alaska,0,0,2,2,0.5
2019-07-07,California,3,5,7,15,0.43333333333333335
2019-07-07,North Dakota,0,1,0,1,0.0
2019-07-07,New York,1,1,2,4,0.5
2019-07-07,Illinois,1,1,2,4,0.5
2019-07-07,Colorado,0,1,2,3,0.3333333333333333
2019-07-07,Florida,4,2,2,8,0.625
2019-07-07,Arizona,2,0,0,2,1.0
2019-07-07,Washington,1,0,0,1,1.0
2019-07-07,Louisiana,1,3,1,5,0.30000000000000004
2019-07-07,Indiana,2,2,1,5,0.5
2019-07-07,Georgia,1,0,1,2,0.75
2019-07-07,New Jersey,0,0,2,2,0.5
2019-07-07,Delaware,0,0,1,1,0.5
2019-07-07,Iowa,1,0,0,1,1.0
2019-07-07,Massachusetts,2,2,3,7,0.5
2019-07-07,Arkansas,3,0,4,7,0.7142857142857142
2019-07-07,Pennsylvania,0,0,1,1,0.5
2019-07-07,Nevada,0,0,1,1,0.5
2019-07-07,New Hampshire,2,0,0,2,1.0
2019-07-07,Nebraska,1,0,2,3,0.6666666666666666
2019-07-07,Michigan,0,1,0,1,0.0
2019-07-07,Missouri,2,0,1,3,0.8333333333333333
2019-07-07,Hawaii,1,1,0,2,0.5
2019-07-07,North Carolina,0,0,1,1,0.5
2019-07-07,Texas,0,1,0,1,0.0
2019-07-07,Oregon,1,0,0,1,1.0
2019-07-06,Alabama,3,2,11,16,0.53125
2019-07-06,Georgia,4,1,9,14,0.6071428571428572
2019-07-06,California,6,2,7,15,0.6333333333333333
2019-07-06,New York,0,3,1,4,0.125
2019-07-06,Texas,1,1,4,6,0.5
2019-07-06,Oregon,0,1,4,5,0.4
2019-07-06,Louisiana,3,1,3,7,0.6428571428571428
2019-07-06,Massachusetts,1,0,3,4,0.625
2019-07-06,Indiana,1,4,8,13,0.38461538461538464
2019-07-06,Hawaii,1,1,2,4,0.5
2019-07-06,Virginia,0,0,1,1,0.5
2019-07-06,Colorado,1,0,3,4,0.625
2019-07-06,Delaware,0,0,5,5,0.5
2019-07-06,Arkansas,1,3,3,7,0.3571428571428571
2019-07-06,Kansas,0,0,2,2,0.5
2019-07-06,Missouri,0,2,1,3,0.16666666666666666
2019-07-06,Illinois,4,1,3,8,0.6875
2019-07-06,Pennsylvania,0,1,1,2,0.25
2019-07-06,Nebraska,0,1,0,1,0.0
2019-07-06,Iowa,0,0,1,1,0.5
2019-07-06,Florida,0,1,2,3,0.3333333333333333
2019-07-06,Arizona,0,0,2,2,0.5
2019-07-06,Kentucky,0,0,3,3,0.5
2019-07-06,Michigan,0,1,2,3,0.3333333333333333
2019-07-06,Nevada,0,0,1,1,0.5
2019-07-06,Ohio,0,0,1,1,0.5
2019-07-06,Alaska,2,0,1,3,0.8333333333333333
2019-07-05,Pennsylvania,1,0,2,3,0.6666666666666666
2019-07-05,California,5,10,16,31,0.4193548387096774
2019-07-05,Alabama,2,2,10,14,0.5
2019-07-05,Alaska,2,0,5,7,0.6428571428571428
2019-07-05,Arizona,5,0,4,9,0.7777777777777778
2019-07-05,Illinois,0,3,9,12,0.375
2019-07-05,Ohio,0,0,2,2,0.5
2019-07-05,Nebraska,1,2,4,7,0.42857142857142855
2019-07-05,Massachusetts,2,2,3,7,0.5
2019-07-05,Arkansas,4,2,6,12,0.5833333333333333
2019-07-05,Georgia,2,0,5,7,0.6428571428571428
2019-07-05,Washington,9,0,1,10,0.9500000000000001
2019-07-05,Connecticut,0,1,0,1,0.0
2019-07-05,Louisiana,1,3,2,6,0.3333333333333333
2019-07-05,Florida,3,1,8,12,0.5833333333333333
2019-07-05,Colorado,3,3,3,9,0.5
2019-07-05,Indiana,7,1,7,15,0.7
2019-07-05,Idaho,0,1,2,3,0.3333333333333333
2019-07-05,Texas,1,1,5,7,0.5
2019-07-05,New York,1,0,3,4,0.625
2019-07-05,Missouri,2,1,1,4,0.625
2019-07-05,Michigan,0,0,1,1,0.5
2019-07-05,Kansas,0,0,2,2,0.5
2019-07-05,Oregon,2,0,2,4,0.75
2019-07-05,North Carolina,0,0,1,1,0.5
2019-07-05,Iowa,1,0,3,4,0.625
2019-07-05,Hawaii,1,2,4,7,0.42857142857142855
2019-07-05,Delaware,1,0,3,4,0.625
2019-07-05,Oklahoma,1,1,0,2,0.5
2019-07-05,New Jersey,0,0,1,1,0.5
2019-07-05,Minnesota,0,0,1,1,0.5
2019-07-05,Kentucky,0,0,1,1,0.5
2019-07-05,Maryland,1,0,0,1,1.0
2019-07-04,New York,1,0,3,4,0.625
2019-07-04,Louisiana,2,1,2,5,0.6000000000000001
2019-07-04,Maine,0,0,1,1,0.5
2019-07-04,Arkansas,2,4,1,7,0.3571428571428571
2019-07-04,Arizona,1,1,1,3,0.5
2019-07-04,Colorado,3,1,3,7,0.6428571428571428
2019-07-04,Alabama,4,3,8,15,0.5333333333333333
2019-07-04,Illinois,2,0,1,3,0.8333333333333333
2019-07-04,Indiana,2,0,4,6,0.6666666666666666
2019-07-04,Texas,0,1,0,1,0.0
2019-07-04,Kansas,0,1,1,2,0.25
2019-07-04,Maryland,1,0,0,1,1.0
2019-07-04,Florida,1,2,2,5,0.4
2019-07-04,California,5,6,8,19,0.47368421052631576
2019-07-04,Hawaii,1,3,0,4,0.25
2019-07-04,Alaska,1,0,1,2,0.75
2019-07-04,Iowa,0,1,1,2,0.25
2019-07-04,Pennsylvania,0,0,2,2,0.5
2019-07-04,Missouri,0,1,1,2,0.25
2019-07-04,Nebraska,0,1,1,2,0.25
2019-07-04,Washington,2,1,1,4,0.625
2019-07-04,Massachusetts,1,1,1,3,0.5
2019-07-04,Delaware,0,0,1,1,0.5
2019-07-04,Connecticut,0,0,1,1,0.5
2019-07-04,Georgia,0,1,0,1,0.0
2019-07-04,Minnesota,0,0,1,1,0.5
2019-07-04,Rhode Island,1,0,0,1,1.0
2019-07-04,New Hampshire,0,0,1,1,0.5
2019-07-04,Michigan,0,0,1,1,0.5
2019-07-04,Oregon,0,1,0,1,0.0
2019-07-03,Kansas,0,1,4,5,0.4
2019-07-03,Massachusetts,3,2,3,8,0.5625
2019-07-03,Alabama,1,8,10,19,0.3157894736842105
2019-07-03,Minnesota,0,1,1,2,0.25
2019-07-03,California,11,5,4,20,0.65
2019-07-03,Alaska,6,0,2,8,0.875
2019-07-03,Indiana,2,0,4,6,0.6666666666666666
2019-07-03,Arkansas,1,3,4,8,0.375
2019-07-03,Louisiana,2,1,0,3,0.6666666666666666
2019-07-03,Georgia,0,0,1,1,0.5
2019-07-03,Florida,5,0,4,9,0.7777777777777778
2019-07-03,Ohio,1,0,1,2,0.75
2019-07-03,Nebraska,0,1,0,1,0.0
2019-07-03,Colorado,2,2,4,8,0.5
2019-07-03,New Hampshire,1,0,1,2,0.75
2019-07-03,Texas,0,1,4,5,0.4
2019-07-03,Iowa,0,0,2,2,0.5
2019-07-03,New York,3,2,0,5,0.6
2019-07-03,Pennsylvania,0,0,1,1,0.5
2019-07-03,Missouri,2,0,0,2,1.0
2019-07-03,Illinois,0,0,2,2,0.5
2019-07-03,Delaware,0,1,2,3,0.3333333333333333
2019-07-03,Washington,0,0,1,1,0.5
2019-07-03,North Carolina,0,0,1,1,0.5
2019-07-03,Hawaii,0,0,1,1,0.5
2019-07-03,Rhode Island,0,1,0,1,0.0
2019-07-03,Virginia,0,1,0,1,0.0
2019-07-03,Kentucky,0,0,1,1,0.5
2019-07-03,Idaho,0,0,2,2,0.5
2019-07-03,Nevada,1,0,0,1,1.0
2019-07-03,New Jersey,0,0,1,1,0.5
2019-07-02,Delaware,0,1,1,2,0.25
2019-07-02,Alabama,1,7,6,14,0.2857142857142857
2019-07-02,Montana,0,0,1,1,0.5
2019-07-02,Colorado,2,3,4,9,0.4444444444444444
2019-07-02,California,11,5,9,25,0.62
2019-07-02,Indiana,0,1,6,7,0.42857142857142855
2019-07-02,Massachusetts,2,2,3,7,0.5
2019-07-02,Alaska,6,1,2,9,0.7777777777777777
2019-07-02,Florida,3,0,6,9,0.6666666666666666
2019-07-02,Hawaii,2,1,1,4,0.625
2019-07-02,Connecticut,1,0,0,1,1.0
2019-07-02,Georgia,0,1,0,1,0.0
2019-07-02,Arkansas,3,4,2,9,0.4444444444444444
2019-07-02,Oregon,1,0,0,1,1.0
2019-07-02,Texas,1,1,1,3,0.5
2019-07-02,Washington,0,1,3,4,0.375
2019-07-02,Illinois,2,1,2,5,0.6000000000000001
2019-07-02,Arizona,1,0,2,3,0.6666666666666666
2019-07-02,North Carolina,1,1,0,2,0.5
2019-07-02,Maryland,2,0,1,3,0.8333333333333333
2019-07-02,South Carolina,0,1,0,1,0.0
2019-07-02,New York,2,3,0,5,0.4
2019-07-02,Iowa,2,0,0,2,1.0
2019-07-02,Idaho,2,2,0,4,0.5
2019-07-02,Louisiana,0,2,1,3,0.16666666666666666
2019-07-02,New Jersey,1,0,0,1,1.0
2019-07-02,Maine,0,0,1,1,0.5
2019-07-02,Rhode Island,2,0,0,2,1.0
2019-07-01,Illinois,3,0,8,11,0.6363636363636364
2019-07-01,Ohio,0,1,1,2,0.25
2019-07-01,Alabama,4,6,10,20,0.45
2019-07-01,Virginia,1,0,0,1,1.0
2019-07-01,Alaska,4,0,2,6,0.8333333333333333
2019-07-01,Washington,0,1,2,3,0.3333333333333333
2019-07-01,California,9,9,19,37,0.5
2019-07-01,Massachusetts,4,2,7,13,0.5769230769230769
2019-07-01,Colorado,6,4,2,12,0.5833333333333334
2019-07-01,Louisiana,0,2,3,5,0.3
2019-07-01,Arkansas,6,3,9,18,0.5833333333333333
2019-07-01,Florida,2,1,8,11,0.5454545454545454
2019-07-01,Oklahoma,0,1,0,1,0.0
2019-07-01,Indiana,5,4,3,12,0.5416666666666667
2019-07-01,Utah,2,1,0,3,0.6666666666666666
2019-07-01,Delaware,2,0,0,2,1.0
2019-07-01,Iowa,1,1,1,3,0.5
2019-07-01,New Mexico,1,0,0,1,1.0
2019-07-01,Texas,1,2,3,6,0.41666666666666663
2019-07-01,New Hampshire,0,0,1,1,0.5
2019-07-01,New York,3,1,2,6,0.6666666666666666
2019-07-01,Pennsylvania,0,2,0,2,0.0
2019-07-01,Idaho,1,3,1,5,0.30000000000000004
2019-07-01,South Carolina,0,0,1,1,0.5
2019-07-01,Hawaii,0,2,2,4,0.25
2019-07-01,Georgia,1,0,1,2,0.75
2019-07-01,Missouri,1,1,0,2,0.5
2019-07-01,Arizona,0,1,1,2,0.25
2019-07-01,Maryland,1,0,0,1,1.0
2019-07-01,Oregon,0,0,1,1,0.5
2019-07-01,Connecticut,1,0,1,2,0.75
2019-07-01,Nevada,0,0,2,2,0.5
2019-06-30,Alabama,3,2,5,10,0.55
2019-06-30,California,4,1,6,11,0.6363636363636364
2019-06-30,Indiana,0,2,1,3,0.16666666666666666
2019-06-30,Massachusetts,2,0,1,3,0.8333333333333333
2019-06-30,Kansas,0,2,2,4,0.25
2019-06-30,Florida,1,4,2,7,0.2857142857142857
2019-06-30,Hawaii,3,1,1,5,0.7
2019-06-30,New York,3,1,1,5,0.7
2019-06-30,Missouri,3,0,0,3,1.0
2019-06-30,Virginia,0,0,1,1,0.5
2019-06-30,Alaska,1,0,1,2,0.75
2019-06-30,Iowa,0,0,2,2,0.5
2019-06-30,Texas,4,1,2,7,0.7142857142857142
2019-06-30,Maine,0,1,0,1,0.0
2019-06-30,Arkansas,0,0,2,2,0.5
2019-06-30,Illinois,0,1,2,3,0.3333333333333333
2019-06-30,Rhode Island,1,1,0,2,0.5
2019-06-30,North Carolina,0,1,0,1,0.0
2019-06-30,New Jersey,0,1,0,1,0.0
2019-06-30,Utah,0,1,0,1,0.0
2019-06-30,Georgia,1,0,0,1,1.0
2019-06-30,Colorado,1,1,0,2,0.5
2019-06-30,Delaware,0,0,1,1,0.5
2019-06-29,Ohio,0,1,0,1,0.0
2019-06-29,Indiana,3,1,4,8,0.625
2019-06-29,Mississippi,0,0,1,1,0.5
2019-06-29,Alaska,3,0,0,3,1.0
2019-06-29,Iowa,0,1,1,2,0.25
2019-06-29,Nebraska,0,2,1,3,0.16666666666666666
2019-06-29,Colorado,2,4,3,9,0.38888888888888884
2019-06-29,Florida,3,2,2,7,0.5714285714285714
2019-06-29,Arkansas,3,1,4,8,0.625
2019-06-29,California,7,4,8,19,0.5789473684210527
2019-06-29,Georgia,0,2,2,4,0.25
2019-06-29,Massachusetts,2,0,2,4,0.75
2019-06-29,Missouri,0,2,1,3,0.16666666666666666
2019-06-29,Oregon,1,0,0,1,1.0
2019-06-29,Hawaii,2,0,0,2,1.0
2019-06-29,New York,4,3,1,8,0.5625
2019-06-29,Louisiana,3,1,2,6,0.6666666666666666
2019-06-29,Texas,1,0,1,2,0.75
2019-06-29,Alabama,3,0,3,6,0.75
2019-06-29,North Carolina,0,1,0,1,0.0
2019-06-29,Arizona,0,1,0,1,0.0
2019-06-29,New Jersey,0,0,1,1,0.5
2019-06-29,South Dakota,0,0,1,1,0.5
2019-06-29,Kansas,1,1,0,2,0.5
2019-06-29,Michigan,0,0,1,1,0.5
2019-06-29,Illinois,3,0,0,3,1.0
2019-06-29,Pennsylvania,0,1,0,1,0.0
2019-06-29,Idaho,0,0,1,1,0.5
2019-06-29,Delaware,0,1,0,1,0.0
2019-06-28,Idaho,2,0,4,6,0.6666666666666666
2019-06-28,Arkansas,2,2,5,9,0.5
2019-06-28,California,9,7,7,23,0.5434782608695652
2019-06-28,Washington,2,0,2,4,0.75
2019-06-28,Indiana,3,0,2,5,0.8
2019-06-28,Delaware,1,0,2,3,0.6666666666666666
2019-06-28,Alaska,0,2,0,2,0.0
2019-06-28,Nebraska,2,0,2,4,0.75
2019-06-28,Kansas,1,0,1,2,0.75
2019-06-28,South Carolina,0,0,1,1,0.5
2019-06-28,Hawaii,1,2,2,5,0.4
2019-06-28,New Jersey,0,1,1,2,0.25
2019-06-28,Florida,2,3,3,8,0.4375
2019-06-28,Minnesota,1,0,0,1,1.0
2019-06-28,Missouri,1,0,0,1,1.0
2019-06-28,Arizona,1,0,0,1,1.0
2019-06-28,New York,2,1,2,5,0.6000000000000001
2019-06-28,Massachusetts,4,6,2,12,0.41666666666666663
2019-06-28,Texas,0,0,2,2,0.5
2019-06-28,Alabama,1,3,4,8,0.375
2019-06-28,Georgia,2,0,1,3,0.8333333333333333
2019-06-28,Colorado,1,2,4,7,0.42857142857142855
2019-06-28,New Mexico,0,0,1,1,0.5
2019-06-28,Illinois,3,1,3,7,0.6428571428571428
2019-06-28,Ohio,0,0,1,1,0.5
2019-06-28,Michigan,1,0,2,3,0.6666666666666666
2019-06-28,Virginia,1,0,0,1,1.0
2019-06-27,Alabama,5,5,11,21,0.5
2019-06-27,Florida,7,4,8,19,0.5789473684210527
2019-06-27,Alaska,2,2,2,6,0.5
2019-06-27,Hawaii,13,4,13,30,0.65
2019-06-27,Arkansas,10,3,7,20,0.675
2019-06-27,Nebraska,2,0,0,2,1.0
2019-06-27,New Jersey,0,0,2,2,0.5
2019-06-27,Colorado,3,4,6,13,0.46153846153846156
2019-06-27,California,8,5,14,27,0.5555555555555556
2019-06-27,Massachusetts,3,3,6,12,0.5
2019-06-27,Louisiana,8,3,3,14,0.6785714285714285
2019-06-27,Maine,0,0,1,1,0.5
2019-06-27,Kansas,2,1,0,3,0.6666666666666666
2019-06-27,Kentucky,0,0,1,1,0.5
2019-06-27,Texas,2,1,4,7,0.5714285714285714
2019-06-27,New York,2,4,5,11,0.40909090909090906
2019-06-27,Indiana,10,2,4,16,0.75
2019-06-27,Minnesota,0,0,2,2,0.5
2019-06-27,Washington,3,0,3,6,0.75
2019-06-27,Arizona,1,2,1,4,0.375
2019-06-27,Virginia,0,0,1,1,0.5
2019-06-27,Michigan,0,0,4,4,0.5
2019-06-27,Oregon,0,1,0,1,0.0
2019-06-27,Georgia,1,2,2,5,0.4
2019-06-27,Illinois,1,0,1,2,0.75
2019-06-27,Idaho,0,0,1,1,0.5
2019-06-27,Maryland,0,0,1,1,0.5
2019-06-27,Delaware,0,0,2,2,0.5
2019-06-27,Connecticut,1,0,0,1,1.0
2019-06-27,Oklahoma,1,0,0,1,1.0
2019-06-27,Missouri,1,0,0,1,1.0
2019-06-27,Utah,0,1,0,1,0.0
2019-06-26,Florida,6,10,10,26,0.42307692307692313
2019-06-26,California,9,9,11,29,0.5
2019-06-26,Michigan,1,0,0,1,1.0
2019-06-26,Connecticut,1,0,1,2,0.75
2019-06-26,Alabama,15,10,6,31,0.5806451612903226
2019-06-26,Alaska,1,0,3,4,0.625
2019-06-26,Indiana,6,3,5,14,0.6071428571428571
2019-06-26,Missouri,1,0,2,3,0.6666666666666666
2019-06-26,Georgia,3,0,4,7,0.7142857142857142
2019-06-26,Texas,0,2,3,5,0.3
2019-06-26,Nebraska,0,3,5,8,0.3125
2019-06-26,Louisiana,1,3,1,5,0.30000000000000004
2019-06-26,Massachusetts,4,6,6,16,0.4375
2019-06-26,New York,0,2,3,5,0.3
2019-06-26,Washington,1,2,2,5,0.4
2019-06-26,Hawaii,4,3,3,10,0.55
2019-06-26,Arkansas,5,1,5,11,0.6818181818181818
2019-06-26,Iowa,1,0,2,3,0.6666666666666666
2019-06-26,Colorado,3,3,3,9,0.5
2019-06-26,Arizona,1,0,1,2,0.75
2019-06-26,Delaware,0,0,2,2,0.5
2019-06-26,Maryland,3,1,0,4,0.75
2019-06-26,North Carolina,0,0,1,1,0.5
2019-06-26,Maine,0,0,1,1,0.5
2019-06-26,Kentucky,0,0,1,1,0.5
2019-06-26,Oregon,2,1,1,4,0.625
2019-06-26,Idaho,2,0,1,3,0.8333333333333333
2019-06-26,Illinois,1,0,1,2,0.75
2019-06-26,Virginia,1,0,0,1,1.0
2019-06-26,Kansas,1,1,0,2,0.5
2019-06-26,Pennsylvania,0,1,0,1,0.0
2019-06-26,Minnesota,1,0,0,1,1.0
2019-06-25,Indiana,1,1,4,6,0.5
2019-06-25,Minnesota,0,0,3,3,0.5
2019-06-25,Florida,3,1,10,14,0.5714285714285714
2019-06-25,New York,1,0,2,3,0.6666666666666666
2019-06-25,Arkansas,5,3,6,14,0.5714285714285714
2019-06-25,Hawaii,1,3,2,6,0.3333333333333333
2019-06-25,Arizona,0,2,1,3,0.16666666666666666
2019-06-25,Georgia,1,0,4,5,0.6000000000000001
2019-06-25,California,4,7,9,20,0.42500000000000004
2019-06-25,Alabama,8,1,2,11,0.8181818181818182
2019-06-25,Missouri,0,0,1,1,0.5
2019-06-25,Iowa,1,2,0,3,0.3333333333333333
2019-06-25,Nebraska,2,1,0,3,0.6666666666666666
2019-06-25,Washington,1,0,2,3,0.6666666666666666
2019-06-25,Texas,2,0,2,4,0.75
2019-06-25,Alaska,2,1,1,4,0.625
2019-06-25,Louisiana,0,0,1,1,0.5
2019-06-25,Nevada,0,0,1,1,0.5
2019-06-25,Massachusetts,1,3,1,5,0.30000000000000004
2019-06-25,Illinois,0,1,2,3,0.3333333333333333
2019-06-25,Pennsylvania,1,0,0,1,1.0
2019-06-25,Colorado,0,0,2,2,0.5
2019-06-25,Idaho,0,2,0,2,0.0
2019-06-25,Delaware,1,0,0,1,1.0
2019-06-25,Kansas,0,1,0,1,0.0
2019-06-25,New Jersey,0,0,2,2,0.5
2019-06-25,Maryland,1,0,0,1,1.0
2019-06-24,California,6,2,8,16,0.625
2019-06-24,Illinois,1,2,2,5,0.4
2019-06-24,Delaware,2,0,1,3,0.8333333333333333
2019-06-24,Florida,2,3,10,15,0.4666666666666667
2019-06-24,Louisiana,6,3,2,11,0.6363636363636364
2019-06-24,Hawaii,6,1,3,10,0.75
2019-06-24,Arkansas,4,4,4,12,0.5
2019-06-24,Colorado,5,0,2,7,0.8571428571428572
2019-06-24,Arizona,0,2,2,4,0.25
2019-06-24,Alabama,2,2,6,10,0.5
2019-06-24,Missouri,1,0,1,2,0.75
2019-06-24,New York,1,2,1,4,0.375
2019-06-24,Georgia,0,3,2,5,0.2
2019-06-24,Texas,2,1,1,4,0.625
2019-06-24,Massachusetts,2,0,2,4,0.75
2019-06-24,Indiana,2,3,2,7,0.42857142857142855
2019-06-24,Alaska,1,0,1,2,0.75
2019-06-24,Nebraska,0,0,1,1,0.5
2019-06-24,New Jersey,0,0,1,1,0.5
2019-06-24,Maryland,1,1,0,2,0.5
2019-06-24,Oregon,1,1,1,3,0.5
2019-06-24,Rhode Island,0,0,1,1,0.5
2019-06-24,Michigan,1,0,0,1,1.0
2019-06-24,Ohio,0,0,1,1,0.5
2019-06-23,Nebraska,2,1,1,4,0.625
2019-06-23,New York,1,0,4,5,0.6000000000000001
2019-06-23,Alabama,1,2,2,5,0.4
2019-06-23,Texas,1,1,5,7,0.5
2019-06-23,Michigan,0,1,2,3,0.3333333333333333
2019-06-23,Delaware,1,0,2,3,0.6666666666666666
2019-06-23,California,8,8,1,17,0.5
2019-06-23,Colorado,2,3,0,5,0.4
2019-06-23,Arkansas,4,2,5,11,0.5909090909090909
2019-06-23,Hawaii,1,1,2,4,0.5
2019-06-23,Georgia,1,2,3,6,0.41666666666666663
2019-06-23,Florida,1,2,2,5,0.4
2019-06-23,Idaho,1,2,0,3,0.3333333333333333
2019-06-23,New Jersey,0,0,2,2,0.5
2019-06-23,Mississippi,1,0,0,1,1.0
2019-06-23,Illinois,2,0,1,3,0.8333333333333333
2019-06-23,Kansas,1,0,0,1,1.0
2019-06-23,Massachusetts,2,0,4,6,0.6666666666666666
2019-06-23,Missouri,1,0,1,2,0.75
2019-06-23,Indiana,2,5,3,10,0.35
2019-06-23,Alaska,1,1,0,2,0.5
2019-06-23,Minnesota,0,0,2,2,0.5
2019-06-23,Louisiana,0,5,1,6,0.08333333333333333
2019-06-23,Oregon,0,0,3,3,0.5
2019-06-23,Washington,2,0,0,2,1.0
2019-06-23,Iowa,1,0,1,2,0.75
2019-06-23,Connecticut,0,0,1,1,0.5
2019-06-23,Ohio,1,0,0,1,1.0
2019-06-22,Idaho,1,0,1,2,0.75
2019-06-22,Hawaii,0,4,6,10,0.3
2019-06-22,Illinois,3,0,2,5,0.8
2019-06-22,Colorado,4,4,2,10,0.5
2019-06-22,California,8,2,5,15,0.7
2019-06-22,Iowa,2,1,2,5,0.6000000000000001
2019-06-22,Indiana,0,2,3,5,0.3
2019-06-22,Florida,3,1,3,7,0.6428571428571428
2019-06-22,Missouri,6,1,1,8,0.8125
2019-06-22,Alabama,0,1,4,5,0.4
2019-06-22,Texas,1,2,3,6,0.41666666666666663
2019-06-22,New Jersey,0,0,1,1,0.5
2019-06-22,Washington,2,3,0,5,0.4
2019-06-22,Massachusetts,3,2,2,7,0.5714285714285714
2019-06-22,Georgia,1,0,1,2,0.75
2019-06-22,Arizona,1,0,3,4,0.625
2019-06-22,Arkansas,1,2,0,3,0.3333333333333333
2019-06-22,New York,3,1,1,5,0.7
2019-06-22,Alaska,2,1,0,3,0.6666666666666666
2019-06-22,Nebraska,0,0,2,2,0.5
2019-06-22,North Dakota,0,1,0,1,0.0
2019-06-22,Oregon,1,1,0,2,0.5
2019-06-22,Delaware,0,1,3,4,0.375
2019-06-22,Michigan,1,0,0,1,1.0
2019-06-22,Connecticut,0,1,0,1,0.0
2019-06-22,Mississippi,0,0,1,1,0.5
2019-06-22,Louisiana,0,0,1,1,0.5
2019-06-22,Rhode Island,0,0,1,1,0.5
2019-06-21,Illinois,1,1,1,3,0.5
2019-06-21,Colorado,2,7,3,12,0.29166666666666663
2019-06-21,Hawaii,7,3,5,15,0.6333333333333333
2019-06-21,California,7,7,10,24,0.5
2019-06-21,Arkansas,5,2,3,10,0.65
2019-06-21,Alabama,1,2,7,10,0.44999999999999996
2019-06-21,Iowa,3,0,3,6,0.75
2019-06-21,Idaho,3,0,0,3,1.0
2019-06-21,New Jersey,0,1,0,1,0.0
2019-06-21,Washington,0,0,3,3,0.5
2019-06-21,Florida,1,0,1,2,0.75
2019-06-21,New York,1,2,0,3,0.3333333333333333
2019-06-21,Louisiana,5,3,7,15,0.5666666666666667
2019-06-21,Kansas,1,1,0,2,0.5
2019-06-21,Nebraska,1,0,1,2,0.75
2019-06-21,Missouri,0,0,4,4,0.5
2019-06-21,Indiana,1,1,4,6,0.5
2019-06-21,Arizona,3,2,2,7,0.5714285714285714
2019-06-21,Delaware,3,1,0,4,0.75
2019-06-21,Massachusetts,4,1,3,8,0.6875
2019-06-21,Alaska,0,0,2,2,0.5
2019-06-21,Oregon,1,1,1,3,0.5
2019-06-21,Ohio,1,0,0,1,1.0
2019-06-21,South Carolina,1,0,0,1,1.0
2019-06-21,West Virginia,1,0,0,1,1.0
2019-06-21,North Carolina,0,1,0,1,0.0
2019-06-21,Nevada,0,0,2,2,0.5
2019-06-21,Minnesota,1,1,0,2,0.5
2019-06-21,Maine,0,0,1,1,0.5
2019-06-21,Maryland,0,1,0,1,0.0
2019-06-21,Pennsylvania,0,0,1,1,0.5
2019-06-20,Alabama,5,3,5,13,0.576923076923077
2019-06-20,Maine,0,1,0,1,0.0
2019-06-20,Idaho,0,0,1,1,0.5
2019-06-20,Pennsylvania,0,1,0,1,0.0
2019-06-20,Delaware,2,1,1,4,0.625
2019-06-20,California,3,6,8,17,0.4117647058823529
2019-06-20,Hawaii,2,3,1,6,0.41666666666666663
2019-06-20,Kentucky,1,0,0,1,1.0
2019-06-20,Colorado,0,0,4,4,0.5
2019-06-20,New York,1,2,2,5,0.4
2019-06-20,Michigan,0,1,0,1,0.0
2019-06-20,Nebraska,1,0,3,4,0.625
2019-06-20,Maryland,0,0,2,2,0.5
2019-06-20,Arkansas,6,0,3,9,0.8333333333333333
2019-06-20,Massachusetts,4,2,1,7,0.6428571428571428
2019-06-20,Florida,0,1,2,3,0.3333333333333333
2019-06-20,Louisiana,3,1,0,4,0.75
2019-06-20,Virginia,1,0,1,2,0.75
2019-06-20,Washington,3,0,3,6,0.75
2019-06-20,Connecticut,0,0,1,1,0.5
2019-06-20,Indiana,1,0,3,4,0.625
2019-06-20,Iowa,0,0,1,1,0.5
2019-06-20,Alaska,1,0,6,7,0.5714285714285714
2019-06-20,Arizona,0,1,2,3,0.3333333333333333
2019-06-20,Missouri,0,1,1,2,0.25
2019-06-20,Texas,1,1,2,4,0.5
2019-06-20,Ohio,0,1,0,1,0.0
2019-06-20,Illinois,1,0,4,5,0.6000000000000001
2019-06-20,Minnesota,1,0,0,1,1.0
2019-06-20,Georgia,1,1,1,3,0.5
2019-06-20,New Jersey,0,1,0,1,0.0
2019-06-20,Rhode Island,0,1,0,1,0.0
2019-06-19,Alabama,7,2,2,11,0.7272727272727273
2019-06-19,Texas,1,0,3,4,0.625
2019-06-19,Nebraska,3,0,1,4,0.875
2019-06-19,Illinois,3,1,4,8,0.625
2019-06-19,Massachusetts,7,3,7,17,0.6176470588235294
2019-06-19,Connecticut,0,1,1,2,0.25
2019-06-19,California,9,4,5,18,0.6388888888888888
2019-06-19,North Dakota,0,0,1,1,0.5
2019-06-19,Florida,1,1,3,5,0.5
2019-06-19,Oregon,0,0,3,3,0.5
2019-06-19,Michigan,0,1,0,1,0.0
2019-06-19,Arkansas,0,4,3,7,0.21428571428571427
2019-06-19,Nevada,2,0,0,2,1.0
2019-06-19,Indiana,1,1,2,4,0.5
2019-06-19,Colorado,3,0,2,5,0.8
2019-06-19,Ohio,0,0,2,2,0.5
2019-06-19,Kentucky,1,0,0,1,1.0
2019-06-19,Alaska,1,0,2,3,0.6666666666666666
2019-06-19,Idaho,2,0,0,2,1.0
2019-06-19,Delaware,2,1,3,6,0.5833333333333333
2019-06-19,Hawaii,1,0,0,1,1.0
2019-06-19,Georgia,1,0,1,2,0.75
2019-06-19,Louisiana,5,1,2,8,0.75
2019-06-19,Iowa,1,1,0,2,0.5
2019-06-19,Washington,0,1,2,3,0.3333333333333333
2019-06-19,Kansas,1,0,0,1,1.0
2019-06-19,New York,1,2,2,5,0.4
2019-06-19,Maryland,0,0,2,2,0.5
2019-06-19,Minnesota,1,0,0,1,1.0
2019-06-19,New Jersey,0,0,1,1,0.5
2019-06-19,Arizona,0,0,1,1,0.5
2019-06-19,Missouri,0,0,1,1,0.5
2019-06-18,California,5,1,6,12,0.6666666666666667
2019-06-18,Nebraska,0,0,1,1,0.5
2019-06-18,Arkansas,6,2,5,13,0.6538461538461539
2019-06-18,Massachusetts,3,2,2,7,0.5714285714285714
2019-06-18,Arizona,1,0,3,4,0.625
2019-06-18,Alabama,2,1,7,10,0.55
2019-06-18,Tennessee,0,1,0,1,0.0
2019-06-18,Florida,3,1,1,5,0.7
2019-06-18,Alaska,2,1,0,3,0.6666666666666666
2019-06-18,Idaho,1,0,1,2,0.75
2019-06-18,Hawaii,4,2,2,8,0.625
2019-06-18,Washington,1,0,1,2,0.75
2019-06-18,Illinois,3,2,2,7,0.5714285714285714
2019-06-18,Indiana,0,2,4,6,0.3333333333333333
2019-06-18,Texas,2,2,3,7,0.5
2019-06-18,Georgia,0,1,1,2,0.25
2019-06-18,Colorado,0,1,2,3,0.3333333333333333
2019-06-18,Kentucky,1,2,1,4,0.375
2019-06-18,Missouri,1,0,1,2,0.75
2019-06-18,Michigan,0,1,0,1,0.0
2019-06-18,Delaware,0,1,1,2,0.25
2019-06-18,New York,4,0,0,4,1.0
2019-06-18,New Jersey,1,0,0,1,1.0
2019-06-18,Oregon,0,1,1,2,0.25
2019-06-18,Iowa,0,0,2,2,0.5
2019-06-18,Louisiana,2,1,1,4,0.625
2019-06-18,Kansas,1,0,0,1,1.0
2019-06-18,Oklahoma,0,0,1,1,0.5
2019-06-18,New Mexico,0,0,1,1,0.5
2019-06-17,California,3,7,5,15,0.3666666666666667
2019-06-17,Indiana,3,3,1,7,0.5
2019-06-17,Massachusetts,6,0,3,9,0.8333333333333333
2019-06-17,Maryland,1,0,0,1,1.0
2019-06-17,Alabama,4,1,5,10,0.65
2019-06-17,Texas,0,1,2,3,0.3333333333333333
2019-06-17,Arkansas,3,0,4,7,0.7142857142857142
2019-06-17,Florida,2,3,2,7,0.42857142857142855
2019-06-17,Alaska,2,0,1,3,0.8333333333333333
2019-06-17,Missouri,0,0,3,3,0.5
2019-06-17,Delaware,4,1,3,8,0.6875
2019-06-17,Colorado,0,0,5,5,0.5
2019-06-17,Georgia,2,1,4,7,0.5714285714285714
2019-06-17,Hawaii,1,1,3,5,0.5
2019-06-17,New York,2,1,1,4,0.625
2019-06-17,Kansas,1,0,1,2,0.75
2019-06-17,Oklahoma,0,1,0,1,0.0
2019-06-17,North Carolina,0,0,1,1,0.5
2019-06-17,Louisiana,2,1,0,3,0.6666666666666666
2019-06-17,Illinois,0,0,2,2,0.5
2019-06-17,Minnesota,0,1,0,1,0.0
2019-06-17,Connecticut,0,0,1,1,0.5
2019-06-17,Washington,1,0,1,2,0.75
2019-06-17,Arizona,2,1,0,3,0.6666666666666666
2019-06-17,Nebraska,1,0,0,1,1.0
2019-06-17,Maine,0,1,0,1,0.0
2019-06-17,Iowa,1,0,0,1,1.0
2019-06-16,Alabama,3,1,4,8,0.625
2019-06-16,Texas,0,1,2,3,0.3333333333333333
2019-06-16,Illinois,2,2,2,6,0.5
2019-06-16,Colorado,4,1,6,11,0.6363636363636364
2019-06-16,Missouri,0,0,1,1,0.5
2019-06-16,Louisiana,1,0,4,5,0.6000000000000001
2019-06-16,Arkansas,0,2,3,5,0.3
2019-06-16,North Carolina,1,0,0,1,1.0
2019-06-16,Indiana,2,2,1,5,0.5
2019-06-16,Hawaii,5,2,6,13,0.6153846153846154
2019-06-16,Iowa,2,0,1,3,0.8333333333333333
2019-06-16,Florida,1,2,1,4,0.375
2019-06-16,Michigan,0,0,1,1,0.5
2019-06-16,Alaska,0,0,2,2,0.5
2019-06-16,New York,1,1,1,3,0.5
2019-06-16,California,4,5,4,13,0.46153846153846156
2019-06-16,Arizona,0,1,0,1,0.0
2019-06-16,New Jersey,0,1,0,1,0.0
2019-06-16,Massachusetts,0,1,0,1,0.0
2019-06-16,Connecticut,0,0,1,1,0.5
2019-06-16,Georgia,0,1,0,1,0.0
2019-06-16,Maryland,1,0,0,1,1.0
2019-06-16,Minnesota,1,0,0,1,1.0
2019-06-16,Oklahoma,0,0,1,1,0.5
2019-06-16,Nebraska,0,1,0,1,0.0
2019-06-15,Nebraska,1,1,1,3,0.5
2019-06-15,Washington,1,1,1,3,0.5
2019-06-15,Texas,2,2,3,7,0.5
2019-06-15,Alaska,3,0,2,5,0.8
2019-06-15,Michigan,0,1,0,1,0.0
2019-06-15,New York,3,0,4,7,0.7142857142857142
2019-06-15,Massachusetts,0,2,6,8,0.375
2019-06-15,Louisiana,2,0,1,3,0.8333333333333333
2019-06-15,Arizona,3,1,1,5,0.7
2019-06-15,Arkansas,2,3,2,7,0.42857142857142855
2019-06-15,Hawaii,0,1,3,4,0.375
2019-06-15,Utah,0,0,1,1,0.5
2019-06-15,California,6,1,1,8,0.8125
2019-06-15,Alabama,4,2,3,9,0.611111111111111
2019-06-15,Illinois,3,2,1,6,0.5833333333333334
2019-06-15,Wisconsin,0,0,1,1,0.5
2019-06-15,Indiana,1,1,2,4,0.5
2019-06-15,Colorado,1,2,1,4,0.375
2019-06-15,Georgia,1,0,1,2,0.75
2019-06-15,Ohio,0,1,0,1,0.0
2019-06-15,Delaware,1,0,2,3,0.6666666666666666
2019-06-15,Iowa,1,1,1,3,0.5
2019-06-15,Oklahoma,1,0,0,1,1.0
2019-06-15,New Jersey,1,0,0,1,1.0
2019-06-15,Florida,0,0,3,3,0.5
2019-06-15,Minnesota,1,0,0,1,1.0
2019-06-15,Pennsylvania,0,1,0,1,0.0
2019-06-15,Missouri,0,0,1,1,0.5
2019-06-14,Indiana,19,9,18,46,0.6086956521739131
2019-06-14,Kentucky,0,0,1,1,0.5
2019-06-14,Arkansas,2,4,4,10,0.4
2019-06-14,Kansas,4,0,0,4,1.0
2019-06-14,Hawaii,1,0,1,2,0.75
2019-06-14,Texas,0,0,1,1,0.5
2019-06-14,Delaware,0,3,2,5,0.2
2019-06-14,Colorado,1,3,4,8,0.375
2019-06-14,Nebraska,0,0,2,2,0.5
2019-06-14,California,14,2,4,20,0.7999999999999999
2019-06-14,New York,2,1,2,5,0.6000000000000001
2019-06-14,Massachusetts,1,0,4,5,0.6000000000000001
2019-06-14,Mississippi,0,0,1,1,0.5
2019-06-14,Alabama,4,2,2,8,0.625
2019-06-14,Maryland,3,0,0,3,1.0
2019-06-14,Washington,0,1,1,2,0.25
2019-06-14,Michigan,1,0,2,3,0.6666666666666666
2019-06-14,Georgia,1,0,2,3,0.6666666666666666
2019-06-14,Louisiana,1,3,2,6,0.3333333333333333
2019-06-14,Alaska,2,0,1,3,0.8333333333333333
2019-06-14,Illinois,0,0,4,4,0.5
2019-06-14,Missouri,0,0,1,1,0.5
2019-06-14,Arizona,0,1,0,1,0.0
2019-06-14,Pennsylvania,0,0,1,1,0.5
2019-06-14,South Carolina,0,0,1,1,0.5
2019-06-14,Florida,1,0,1,2,0.75
2019-06-14,Iowa,1,0,0,1,1.0
2019-06-13,Arkansas,6,3,6,15,0.6000000000000001
2019-06-13,Alabama,5,0,2,7,0.8571428571428572
2019-06-13,New Jersey,1,1,1,3,0.5
2019-06-13,Indiana,1,4,2,7,0.2857142857142857
2019-06-13,New York,3,0,1,4,0.875
2019-06-13,California,6,6,7,19,0.5
2019-06-13,Massachusetts,1,3,7,11,0.40909090909090906
2019-06-13,Alaska,2,0,1,3,0.8333333333333333
2019-06-13,Hawaii,1,0,4,5,0.6000000000000001
2019-06-13,Washington,0,0,2,2,0.5
2019-06-13,Georgia,0,2,5,7,0.35714285714285715
2019-06-13,Illinois,0,2,3,5,0.3
2019-06-13,Ohio,0,0,1,1,0.5
2019-06-13,Arizona,2,0,2,4,0.75
2019-06-13,Florida,1,0,1,2,0.75
2019-06-13,Wisconsin,1,0,0,1,1.0
2019-06-13,Iowa,1,1,0,2,0.5
2019-06-13,North Carolina,0,0,1,1,0.5
2019-06-13,Kentucky,1,2,1,4,0.375
2019-06-13,Louisiana,4,0,1,5,0.9
2019-06-13,Virginia,0,1,0,1,0.0
2019-06-13,Idaho,0,0,1,1,0.5
2019-06-13,Texas,0,0,1,1,0.5
2019-06-13,Nebraska,0,0,2,2,0.5
2019-06-13,Kansas,0,0,1,1,0.5
2019-06-13,Missouri,7,0,0,7,1.0
2019-06-13,Colorado,0,1,0,1,0.0
2019-06-13,North Dakota,0,0,1,1,0.5
2019-06-12,Hawaii,4,2,2,8,0.625
2019-06-12,California,7,9,8,24,0.45833333333333337
2019-06-12,Arizona,1,3,2,6,0.3333333333333333
2019-06-12,Alaska,3,0,4,7,0.7142857142857142
2019-06-12,Delaware,0,1,2,3,0.3333333333333333
2019-06-12,Illinois,2,2,4,8,0.5
2019-06-12,Massachusetts,2,0,7,9,0.6111111111111112
2019-06-12,Georgia,2,1,0,3,0.6666666666666666
2019-06-12,Kansas,0,1,0,1,0.0
2019-06-12,Indiana,3,3,8,14,0.5
2019-06-12,Colorado,4,1,5,10,0.65
2019-06-12,New Jersey,0,0,1,1,0.5
2019-06-12,Arkansas,3,2,4,9,0.5555555555555556
2019-06-12,Louisiana,4,1,2,7,0.7142857142857142
2019-06-12,Texas,1,0,2,3,0.6666666666666666
2019-06-12,Nebraska,1,1,1,3,0.5
2019-06-12,New York,8,2,6,16,0.6875
2019-06-12,Florida,1,2,3,6,0.41666666666666663
2019-06-12,Connecticut,0,0,1,1,0.5
2019-06-12,Alabama,4,1,4,9,0.6666666666666666
2019-06-12,Idaho,0,1,0,1,0.0
2019-06-12,Iowa,0,0,3,3,0.5
2019-06-12,North Carolina,0,1,0,1,0.0
2019-06-11,California,14,8,20,42,0.5714285714285714
2019-06-11,New York,1,3,8,12,0.41666666666666663
2019-06-11,Colorado,2,2,4,8,0.5
2019-06-11,Missouri,2,0,4,6,0.6666666666666666
2019-06-11,Arkansas,2,3,7,12,0.45833333333333337
2019-06-11,Maryland,3,0,2,5,0.8
2019-06-11,Alabama,6,1,10,17,0.6470588235294118
2019-06-11,Louisiana,2,0,4,6,0.6666666666666666
2019-06-11,Georgia,1,2,4,7,0.42857142857142855
2019-06-11,Florida,1,2,2,5,0.4
2019-06-11,Kentucky,1,1,0,2,0.5
2019-06-11,Massachusetts,4,2,4,10,0.6000000000000001
2019-06-11,Michigan,0,0,1,1,0.5
2019-06-11,Iowa,0,0,1,1,0.5
2019-06-11,Pennsylvania,0,2,2,4,0.25
2019-06-11,Maine,0,1,0,1,0.0
2019-06-11,Washington,0,1,0,1,0.0
2019-06-11,Illinois,0,3,2,5,0.2
2019-06-11,Texas,2,1,0,3,0.6666666666666666
2019-06-11,Connecticut,0,0,1,1,0.5
2019-06-11,Indiana,2,1,5,8,0.5625
2019-06-11,Delaware,1,2,1,4,0.375
2019-06-11,Arizona,2,0,3,5,0.7
2019-06-11,Hawaii,5,1,2,8,0.75
2019-06-11,New Jersey,0,1,1,2,0.25
2019-06-11,Oregon,0,0,1,1,0.5
2019-06-11,Kansas,1,0,0,1,1.0
2019-06-11,Alaska,0,0,4,4,0.5
2019-06-11,Nebraska,2,0,0,2,1.0
2019-06-11,Minnesota,0,0,1,1,0.5
2019-06-11,Idaho,1,0,0,1,1.0
2019-06-11,Oklahoma,0,1,0,1,0.0
2019-06-10,Arkansas,3,3,9,15,0.5
2019-06-10,Washington,0,0,2,2,0.5
2019-06-10,California,5,6,25,36,0.4861111111111111
2019-06-10,New York,5,1,0,6,0.8333333333333334
2019-06-10,Maryland,1,0,3,4,0.625
2019-06-10,Hawaii,8,1,2,11,0.8181818181818182
2019-06-10,Pennsylvania,2,0,0,2,1.0
2019-06-10,Oklahoma,0,2,0,2,0.0
2019-06-10,Illinois,1,0,1,2,0.75
2019-06-10,Louisiana,2,1,4,7,0.5714285714285714
2019-06-10,Missouri,2,2,0,4,0.5
2019-06-10,Michigan,1,0,1,2,0.75
2019-06-10,Alaska,0,3,2,5,0.2
2019-06-10,Minnesota,1,0,0,1,1.0
2019-06-10,Kansas,1,0,1,2,0.75
2019-06-10,Indiana,3,3,4,10,0.5
2019-06-10,Alabama,4,4,6,14,0.5
2019-06-10,Massachusetts,4,0,2,6,0.8333333333333333
2019-06-10,Arizona,0,0,1,1,0.5
2019-06-10,Virginia,0,1,0,1,0.0
2019-06-10,Texas,3,0,0,3,1.0
2019-06-10,Nebraska,1,1,0,2,0.5
2019-06-10,Florida,1,1,2,4,0.5
2019-06-10,New Jersey,2,0,1,3,0.8333333333333333
2019-06-10,Colorado,0,0,2,2,0.5
2019-06-10,New Hampshire,2,0,1,3,0.8333333333333333
2019-06-10,Georgia,1,0,0,1,1.0
2019-06-10,Idaho,1,0,0,1,1.0
2019-06-10,Iowa,1,0,0,1,1.0
2019-06-10,Maine,1,0,0,1,1.0
2019-06-09,Delaware,1,0,4,5,0.6000000000000001
2019-06-09,Alabama,4,3,6,13,0.5384615384615385
2019-06-09,California,6,6,10,22,0.5
2019-06-09,Texas,1,1,1,3,0.5
2019-06-09,Oregon,1,0,1,2,0.75
2019-06-09,Georgia,0,0,3,3,0.5
2019-06-09,Maryland,0,0,1,1,0.5
2019-06-09,Hawaii,3,0,3,6,0.75
2019-06-09,Alaska,1,0,1,2,0.75
2019-06-09,Indiana,1,0,2,3,0.6666666666666666
2019-06-09,New Jersey,4,1,3,8,0.6875
2019-06-09,Pennsylvania,0,0,1,1,0.5
2019-06-09,Illinois,2,3,2,7,0.42857142857142855
2019-06-09,Colorado,1,1,2,4,0.5
2019-06-09,Louisiana,1,0,1,2,0.75
2019-06-09,Florida,5,1,3,9,0.7222222222222222
2019-06-09,Arizona,0,3,1,4,0.125
2019-06-09,New Hampshire,1,1,0,2,0.5
2019-06-09,Massachusetts,1,1,1,3,0.5
2019-06-09,Arkansas,3,5,4,12,0.41666666666666663
2019-06-09,New York,0,2,2,4,0.25
2019-06-09,Nebraska,1,1,1,3,0.5
2019-06-09,Idaho,0,1,0,1,0.0
2019-06-09,Kentucky,0,1,1,2,0.25
2019-06-09,Missouri,0,0,1,1,0.5
2019-06-09,Michigan,0,1,0,1,0.0
2019-06-09,Kansas,1,0,0,1,1.0
2019-06-09,Washington,0,1,0,1,0.0
2019-06-08,North Carolina,0,1,1,2,0.25
2019-06-08,California,13,4,3,20,0.725
2019-06-08,Hawaii,3,1,4,8,0.625
2019-06-08,Missouri,3,0,1,4,0.875
2019-06-08,Arizona,0,0,1,1,0.5
2019-06-08,Ohio,1,0,0,1,1.0
2019-06-08,New Jersey,1,2,1,4,0.375
2019-06-08,Illinois,0,0,3,3,0.5
2019-06-08,Florida,2,1,2,5,0.6000000000000001
2019-06-08,Kansas,1,1,0,2,0.5
2019-06-08,Alaska,1,1,5,7,0.5
2019-06-08,Massachusetts,4,2,1,7,0.6428571428571428
2019-06-08,Arkansas,6,3,2,11,0.6363636363636364
2019-06-08,Alabama,3,4,3,10,0.44999999999999996
2019-06-08,Indiana,0,2,1,3,0.16666666666666666
2019-06-08,Texas,0,3,1,4,0.125
2019-06-08,Colorado,0,1,0,1,0.0
2019-06-08,Delaware,1,1,1,3,0.5
2019-06-08,Georgia,0,0,2,2,0.5
2019-06-08,Nebraska,0,0,2,2,0.5
2019-06-08,Connecticut,1,0,0,1,1.0
2019-06-08,Oregon,0,1,0,1,0.0
2019-06-08,Mississippi,0,0,1,1,0.5
2019-06-08,New Hampshire,0,0,1,1,0.5
2019-06-08,Washington,0,0,1,1,0.5
2019-06-08,Louisiana,0,0,1,1,0.5
2019-06-07,California,11,5,12,28,0.6071428571428571
2019-06-07,Washington,1,0,1,2,0.75
2019-06-07,Alabama,5,0,7,12,0.7083333333333334
2019-06-07,Missouri,1,0,2,3,0.6666666666666666
2019-06-07,Florida,3,4,1,8,0.4375
2019-06-07,Louisiana,2,3,3,8,0.4375
2019-06-07,Idaho,2,1,0,3,0.6666666666666666
2019-06-07,Alaska,2,1,5,8,0.5625
2019-06-07,Nebraska,3,2,1,6,0.5833333333333334
2019-06-07,Colorado,1,1,0,2,0.5
2019-06-07,Illinois,4,2,1,7,0.6428571428571428
2019-06-07,Arkansas,0,4,5,9,0.2777777777777778
2019-06-07,Arizona,0,0,1,1,0.5
2019-06-07,Hawaii,5,2,2,9,0.6666666666666667
2019-06-07,New Jersey,0,0,3,3,0.5
2019-06-07,Massachusetts,5,1,1,7,0.7857142857142857
2019-06-07,Texas,2,0,3,5,0.7
2019-06-07,Delaware,1,5,1,7,0.21428571428571427
2019-06-07,Iowa,1,1,0,2,0.5
2019-06-07,Indiana,2,2,6,10,0.5
2019-06-07,New York,0,1,1,2,0.25
2019-06-07,Georgia,0,1,0,1,0.0
2019-06-07,Kentucky,0,1,1,2,0.25
2019-06-07,Pennsylvania,0,1,0,1,0.0
2019-06-07,Oregon,1,0,0,1,1.0
2019-06-07,New Mexico,1,0,0,1,1.0
2019-06-07,Kansas,0,0,1,1,0.5
2019-06-06,New York,11,1,6,18,0.7777777777777778
2019-06-06,Missouri,1,0,0,1,1.0
2019-06-06,California,10,4,14,28,0.6071428571428572
2019-06-06,Nebraska,0,1,2,3,0.3333333333333333
2019-06-06,Colorado,4,1,2,7,0.7142857142857142
2019-06-06,Indiana,6,1,6,13,0.6923076923076923
2019-06-06,Massachusetts,3,2,4,9,0.5555555555555556
2019-06-06,Hawaii,4,3,2,9,0.5555555555555556
2019-06-06,Oregon,1,2,1,4,0.375
2019-06-06,Washington,6,0,0,6,1.0
2019-06-06,Louisiana,3,0,0,3,1.0
2019-06-06,Alabama,3,4,2,9,0.4444444444444444
2019-06-06,Illinois,1,1,2,4,0.5
2019-06-06,Arkansas,3,2,4,9,0.5555555555555556
2019-06-06,Florida,3,2,5,10,0.55
2019-06-06,Arizona,2,0,0,2,1.0
2019-06-06,Idaho,2,2,1,5,0.5
2019-06-06,Alaska,2,0,0,2,1.0
2019-06-06,Texas,0,1,2,3,0.3333333333333333
2019-06-06,Wisconsin,0,0,1,1,0.5
2019-06-06,Kentucky,1,0,0,1,1.0
2019-06-06,Michigan,0,2,0,2,0.0
2019-06-06,Georgia,1,2,0,3,0.3333333333333333
2019-06-06,Delaware,2,0,1,3,0.8333333333333333
2019-06-06,Kansas,0,3,0,3,0.0
2019-06-06,Maryland,2,0,1,3,0.8333333333333333
2019-06-06,Iowa,0,1,1,2,0.25
2019-06-06,Utah,0,0,1,1,0.5
2019-06-05,Hawaii,9,2,3,14,0.75
2019-06-05,Arkansas,4,2,3,9,0.611111111111111
2019-06-05,Oregon,1,0,0,1,1.0
2019-06-05,Missouri,3,0,0,3,1.0
2019-06-05,Indiana,6,2,7,15,0.6333333333333333
2019-06-05,Alabama,8,1,4,13,0.7692307692307693
2019-06-05,Illinois,1,3,0,4,0.25
2019-06-05,Georgia,0,2,2,4,0.25
2019-06-05,California,15,3,5,23,0.7608695652173914
2019-06-05,Nebraska,1,2,1,4,0.375
2019-06-05,Colorado,9,1,6,16,0.75
2019-06-05,Massachusetts,10,3,5,18,0.6944444444444444
2019-06-05,Florida,3,2,4,9,0.5555555555555556
2019-06-05,Maine,0,0,1,1,0.5
2019-06-05,New York,7,4,3,14,0.6071428571428571
2019-06-05,Connecticut,2,0,0,2,1.0
2019-06-05,Alaska,2,1,4,7,0.5714285714285714
2019-06-05,Louisiana,5,0,4,9,0.7777777777777778
2019-06-05,Idaho,0,0,1,1,0.5
2019-06-05,New Jersey,0,0,1,1,0.5
2019-06-05,Texas,2,1,1,4,0.625
2019-06-05,Delaware,4,1,1,6,0.75
2019-06-05,Mississippi,0,2,0,2,0.0
2019-06-05,Washington,2,0,1,3,0.8333333333333333
2019-06-05,Michigan,1,0,0,1,1.0
2019-06-05,Kansas,0,0,1,1,0.5
2019-06-04,Arkansas,3,4,6,13,0.46153846153846156
2019-06-04,Georgia,1,1,3,5,0.5
2019-06-04,California,10,6,6,22,0.5909090909090908
2019-06-04,Ohio,2,1,0,3,0.6666666666666666
2019-06-04,Indiana,3,3,5,11,0.5
2019-06-04,Colorado,5,0,6,11,0.7272727272727273
2019-06-04,Nebraska,1,1,1,3,0.5
2019-06-04,Illinois,0,2,3,5,0.3
2019-06-04,Alabama,6,6,5,17,0.5
2019-06-04,Hawaii,5,4,2,11,0.5454545454545454
2019-06-04,Washington,1,0,1,2,0.75
2019-06-04,New York,7,2,2,11,0.7272727272727273
2019-06-04,Delaware,4,2,5,11,0.5909090909090909
2019-06-04,Kansas,0,0,2,2,0.5
2019-06-04,Florida,3,4,4,11,0.45454545454545453
2019-06-04,Massachusetts,8,2,4,14,0.7142857142857142
2019-06-04,Louisiana,4,0,2,6,0.8333333333333333
2019-06-04,Pennsylvania,1,0,0,1,1.0
2019-06-04,Michigan,0,0,1,1,0.5
2019-06-04,Oregon,1,0,0,1,1.0
2019-06-04,North Carolina,1,0,0,1,1.0
2019-06-04,Arizona,0,2,2,4,0.25
2019-06-04,Alaska,3,2,1,6,0.5833333333333334
2019-06-04,Missouri,0,1,1,2,0.25
2019-06-04,Texas,3,0,0,3,1.0
2019-06-04,Minnesota,1,0,0,1,1.0
2019-06-04,Iowa,0,0,2,2,0.5
2019-06-04,Connecticut,1,0,0,1,1.0
2019-06-04,Idaho,0,1,0,1,0.0
2019-06-03,Massachusetts,2,0,5,7,0.6428571428571428
2019-06-03,Florida,2,0,2,4,0.75
2019-06-03,New York,2,1,3,6,0.5833333333333333
2019-06-03,Illinois,2,2,2,6,0.5
2019-06-03,California,5,3,14,22,0.5454545454545454
2019-06-03,Alabama,6,2,6,14,0.6428571428571428
2019-06-03,Alaska,2,3,3,8,0.4375
2019-06-03,Washington,0,1,1,2,0.25
2019-06-03,Arkansas,1,2,4,7,0.42857142857142855
2019-06-03,Hawaii,3,0,3,6,0.75
2019-06-03,Delaware,2,1,0,3,0.6666666666666666
2019-06-03,Idaho,2,0,0,2,1.0
2019-06-03,Iowa,1,0,1,2,0.75
2019-06-03,Colorado,2,1,1,4,0.625
2019-06-03,New Jersey,0,1,0,1,0.0
2019-06-03,Louisiana,0,0,3,3,0.5
2019-06-03,Ohio,0,1,0,1,0.0
2019-06-03,Oregon,1,3,0,4,0.25
2019-06-03,Arizona,0,1,2,3,0.3333333333333333
2019-06-03,Pennsylvania,0,0,1,1,0.5
2019-06-03,Indiana,1,0,0,1,1.0
2019-06-03,Georgia,0,0,2,2,0.5
2019-06-03,Texas,2,1,2,5,0.6000000000000001
2019-06-03,Nebraska,1,0,0,1,1.0
2019-06-03,Michigan,0,2,0,2,0.0
2019-06-03,New Hampshire,1,0,0,1,1.0
2019-06-02,Hawaii,1,0,0,1,1.0
2019-06-02,Arkansas,2,4,4,10,0.4
2019-06-02,Alabama,2,5,2,9,0.3333333333333333
2019-06-02,Arizona,0,2,3,5,0.3
2019-06-02,Louisiana,1,0,2,3,0.6666666666666666
2019-06-02,Alaska,1,0,2,3,0.6666666666666666
2019-06-02,California,5,4,8,17,0.5294117647058824
2019-06-02,Massachusetts,1,1,3,5,0.5
2019-06-02,Kansas,1,0,1,2,0.75
2019-06-02,Iowa,2,0,0,2,1.0
2019-06-02,Indiana,0,1,3,4,0.375
2019-06-02,Nebraska,3,0,0,3,1.0
2019-06-02,New York,4,2,5,11,0.5909090909090909
2019-06-02,Florida,3,0,3,6,0.75
2019-06-02,Washington,1,1,0,2,0.5
2019-06-02,Virginia,1,1,0,2,0.5
2019-06-02,Colorado,0,0,1,1,0.5
2019-06-02,Missouri,0,1,1,2,0.25
2019-06-02,Illinois,0,1,0,1,0.0
2019-06-02,Utah,0,0,1,1,0.5
2019-06-02,Georgia,0,1,0,1,0.0
2019-06-02,Idaho,1,0,1,2,0.75
2019-06-02,Delaware,1,0,0,1,1.0
2019-06-02,Texas,1,1,0,2,0.5
2019-06-02,Maryland,0,0,1,1,0.5
2019-06-02,Kentucky,0,0,1,1,0.5
2019-06-02,Rhode Island,0,0,1,1,0.5
2019-06-01,Massachusetts,2,1,3,6,0.5833333333333333
2019-06-01,Florida,0,2,3,5,0.3
2019-06-01,Hawaii,3,3,0,6,0.5
2019-06-01,California,6,7,10,23,0.4782608695652174
2019-06-01,Georgia,2,1,0,3,0.6666666666666666
2019-06-01,Colorado,0,3,0,3,0.0
2019-06-01,Delaware,1,1,2,4,0.5
2019-06-01,Arizona,0,1,2,3,0.3333333333333333
2019-06-01,Washington,1,0,0,1,1.0
2019-06-01,Texas,0,0,1,1,0.5
2019-06-01,Arkansas,3,1,5,9,0.6111111111111112
2019-06-01,Ohio,0,0,1,1,0.5
2019-06-01,Indiana,3,2,3,8,0.5625
2019-06-01,New York,2,0,2,4,0.75
2019-06-01,Illinois,0,1,2,3,0.3333333333333333
2019-06-01,Alabama,2,0,2,4,0.75
2019-06-01,Idaho,1,0,2,3,0.6666666666666666
2019-06-01,Louisiana,0,1,1,2,0.25
2019-06-01,Missouri,0,0,1,1,0.5
2019-06-01,Nebraska,2,0,2,4,0.75
2019-06-01,Minnesota,0,0,2,2,0.5
2019-06-01,Montana,0,1,0,1,0.0
2019-06-01,New Mexico,2,0,0,2,1.0
2019-06-01,Oregon,1,0,0,1,1.0
2019-06-01,Maryland,0,1,0,1,0.0
2019-06-01,Alaska,1,0,0,1,1.0
2019-06-01,Michigan,0,1,0,1,0.0
2019-05-31,Texas,0,3,2,5,0.2
2019-05-31,Arizona,2,1,1,4,0.625
2019-05-31,Florida,1,1,3,5,0.5
2019-05-31,Massachusetts,5,1,5,11,0.6818181818181818
2019-05-31,Ohio,0,0,1,1,0.5
2019-05-31,Delaware,2,0,2,4,0.75
2019-05-31,Colorado,3,0,5,8,0.6875
2019-05-31,California,6,8,4,18,0.4444444444444444
2019-05-31,Missouri,3,0,0,3,1.0
2019-05-31,Illinois,2,1,2,5,0.6000000000000001
2019-05-31,Alabama,6,1,2,9,0.7777777777777777
2019-05-31,Iowa,0,0,2,2,0.5
2019-05-31,Hawaii,2,1,1,4,0.625
2019-05-31,Indiana,2,2,3,7,0.5
2019-05-31,Alaska,2,1,0,3,0.6666666666666666
2019-05-31,Kansas,2,1,1,4,0.625
2019-05-31,Montana,0,0,1,1,0.5
2019-05-31,Arkansas,2,2,3,7,0.5
2019-05-31,Georgia,1,0,1,2,0.75
2019-05-31,Oklahoma,0,0,1,1,0.5
2019-05-31,New Jersey,1,0,1,2,0.75
2019-05-31,Nevada,1,0,0,1,1.0
2019-05-31,Washington,1,0,1,2,0.75
2019-05-31,North Carolina,1,0,0,1,1.0
2019-05-31,Nebraska,0,0,1,1,0.5
2019-05-31,New York,0,1,0,1,0.0
2019-05-31,Louisiana,2,0,0,2,1.0
2019-05-30,Hawaii,3,3,4,10,0.5
2019-05-30,Texas,2,0,4,6,0.6666666666666666
2019-05-30,Alabama,5,1,3,9,0.7222222222222222
2019-05-30,Massachusetts,7,1,2,10,0.7999999999999999
2019-05-30,Florida,3,1,3,7,0.6428571428571428
2019-05-30,New Jersey,0,1,1,2,0.25
2019-05-30,Colorado,1,3,3,7,0.3571428571428571
2019-05-30,Indiana,1,2,1,4,0.375
2019-05-30,Arizona,0,1,0,1,0.0
2019-05-30,Washington,0,0,2,2,0.5
2019-05-30,New York,4,1,2,7,0.7142857142857142
2019-05-30,California,3,4,7,14,0.4642857142857143
2019-05-30,Arkansas,4,2,1,7,0.6428571428571428
2019-05-30,Alaska,1,0,1,2,0.75
2019-05-30,Minnesota,1,0,2,3,0.6666666666666666
2019-05-30,Connecticut,0,1,2,3,0.3333333333333333
2019-05-30,North Carolina,0,0,1,1,0.5
2019-05-30,Georgia,1,0,1,2,0.75
2019-05-30,Kansas,1,1,1,3,0.5
2019-05-30,Illinois,2,1,2,5,0.6000000000000001
2019-05-30,Nebraska,2,0,1,3,0.8333333333333333
2019-05-30,Oregon,1,0,0,1,1.0
2019-05-30,Delaware,1,0,0,1,1.0
2019-05-30,Pennsylvania,0,1,0,1,0.0
2019-05-30,Missouri,0,0,1,1,0.5
2019-05-30,Michigan,1,0,0,1,1.0
2019-05-30,Maine,0,0,1,1,0.5
2019-05-30,Wisconsin,0,1,0,1,0.0
2019-05-30,Iowa,0,1,0,1,0.0
2019-05-29,Colorado,1,2,1,4,0.375
2019-05-29,Alabama,2,13,4,19,0.21052631578947367
2019-05-29,Florida,1,0,1,2,0.75
2019-05-29,Louisiana,1,1,1,3,0.5
2019-05-29,Massachusetts,3,4,4,11,0.45454545454545453
2019-05-29,Alaska,3,0,3,6,0.75
2019-05-29,New York,2,1,2,5,0.6000000000000001
2019-05-29,Iowa,1,1,3,5,0.5
2019-05-29,California,6,4,14,24,0.5416666666666667
2019-05-29,Georgia,4,0,4,8,0.75
2019-05-29,Arkansas,3,2,3,8,0.5625
2019-05-29,Idaho,0,0,2,2,0.5
2019-05-29,Texas,1,2,2,5,0.4
2019-05-29,Indiana,3,1,5,9,0.6111111111111112
2019-05-29,Hawaii,2,2,1,5,0.5
2019-05-29,Nebraska,0,1,1,2,0.25
2019-05-29,Arizona,3,1,0,4,0.75
2019-05-29,Nevada,0,1,1,2,0.25
2019-05-29,Oregon,0,1,0,1,0.0
2019-05-29,Delaware,0,2,1,3,0.16666666666666666
2019-05-29,Illinois,0,2,1,3,0.16666666666666666
2019-05-29,Maine,1,0,0,1,1.0
2019-05-29,Oklahoma,0,1,0,1,0.0
2019-05-29,North Carolina,1,0,0,1,1.0
2019-05-29,Missouri,0,1,0,1,0.0
2019-05-29,Connecticut,1,0,0,1,1.0
2019-05-29,Washington,1,1,0,2,0.5
2019-05-28,Louisiana,5,2,2,9,0.6666666666666667
2019-05-28,Kentucky,1,1,1,3,0.5
2019-05-28,New Mexico,0,0,1,1,0.5
2019-05-28,Alabama,4,3,7,14,0.5357142857142857
2019-05-28,Nebraska,0,4,2,6,0.16666666666666666
2019-05-28,Massachusetts,7,4,10,21,0.5714285714285714
2019-05-28,Washington,2,0,1,3,0.8333333333333333
2019-05-28,California,5,5,7,17,0.5
2019-05-28,Illinois,0,0,14,14,0.5
2019-05-28,New York,3,3,3,9,0.5
2019-05-28,Arkansas,3,5,7,15,0.43333333333333335
2019-05-28,Georgia,0,2,4,6,0.3333333333333333
2019-05-28,Alaska,2,2,3,7,0.5
2019-05-28,Hawaii,1,0,2,3,0.6666666666666666
2019-05-28,Iowa,1,1,0,2,0.5
2019-05-28,Indiana,1,4,1,6,0.25
2019-05-28,Kansas,0,2,2,4,0.25
2019-05-28,Colorado,0,4,4,8,0.25
2019-05-28,Delaware,0,1,2,3,0.3333333333333333
2019-05-28,South Carolina,0,0,1,1,0.5
2019-05-28,Missouri,1,0,0,1,1.0
2019-05-28,Florida,2,1,2,5,0.6000000000000001
2019-05-28,Maryland,0,0,1,1,0.5
2019-05-28,New Jersey,0,0,1,1,0.5
2019-05-28,Ohio,0,1,2,3,0.3333333333333333
2019-05-28,Arizona,0,1,0,1,0.0
2019-05-28,Virginia,1,0,1,2,0.75
2019-05-28,Texas,0,0,1,1,0.5
2019-05-28,Michigan,1,0,1,2,0.75
2019-05-28,Idaho,1,0,0,1,1.0
2019-05-28,Connecticut,0,1,0,1,0.0
2019-05-27,Florida,2,1,4,7,0.5714285714285714
2019-05-27,Georgia,0,0,4,4,0.5
2019-05-27,Indiana,1,0,3,4,0.625
2019-05-27,New Mexico,0,1,0,1,0.0
2019-05-27,Alabama,6,9,6,21,0.42857142857142855
2019-05-27,Alaska,3,1,1,5,0.7
2019-05-27,California,6,0,7,13,0.7307692307692308
2019-05-27,Nebraska,2,2,2,6,0.5
2019-05-27,Louisiana,2,0,3,5,0.7
2019-05-27,Massachusetts,2,0,2,4,0.75
2019-05-27,New York,3,1,3,7,0.6428571428571428
2019-05-27,Arkansas,2,3,5,10,0.45
2019-05-27,Colorado,1,0,2,3,0.6666666666666666
2019-05-27,Hawaii,0,3,0,3,0.0
2019-05-27,Texas,0,0,1,1,0.5
2019-05-27,Delaware,1,0,3,4,0.625
2019-05-27,Arizona,0,0,3,3,0.5
2019-05-27,North Carolina,0,0,1,1,0.5
2019-05-27,Kansas,0,0,1,1,0.5
2019-05-27,Washington,0,0,2,2,0.5
2019-05-27,Connecticut,1,0,1,2,0.75
2019-05-27,Oregon,0,1,1,2,0.25
2019-05-27,Minnesota,0,0,1,1,0.5
2019-05-27,Iowa,1,1,0,2,0.5
2019-05-27,New Jersey,1,0,0,1,1.0
2019-05-27,Utah,0,0,1,1,0.5
2019-05-27,North Dakota,1,0,0,1,1.0
2019-05-27,Idaho,1,0,0,1,1.0
2019-05-27,Missouri,2,0,0,2,1.0
2019-05-26,Arizona,1,2,3,6,0.41666666666666663
2019-05-26,Missouri,0,1,1,2,0.25
2019-05-26,Colorado,2,0,0,2,1.0
2019-05-26,California,8,3,6,17,0.6470588235294118
2019-05-26,Arkansas,4,3,5,12,0.5416666666666666
2019-05-26,Alabama,1,2,1,4,0.375
2019-05-26,Florida,2,2,2,6,0.5
2019-05-26,Massachusetts,3,1,1,5,0.7
2019-05-26,Nebraska,0,1,3,4,0.375
2019-05-26,New York,0,0,3,3,0.5
2019-05-26,Louisiana,3,1,1,5,0.7
2019-05-26,Hawaii,0,3,1,4,0.125
2019-05-26,Indiana,1,2,0,3,0.3333333333333333
2019-05-26,Georgia,2,2,2,6,0.5
2019-05-26,Alaska,2,0,4,6,0.6666666666666666
2019-05-26,Kansas,1,0,1,2,0.75
2019-05-26,Texas,0,0,1,1,0.5
2019-05-26,Illinois,1,0,0,1,1.0
2019-05-26,Iowa,1,1,1,3,0.5
2019-05-26,Kentucky,1,1,0,2,0.5
2019-05-26,Pennsylvania,0,0,1,1,0.5
2019-05-26,Idaho,1,0,0,1,1.0
2019-05-26,Delaware,0,1,0,1,0.0
2019-05-25,California,9,2,7,18,0.6944444444444444
2019-05-25,Illinois,0,5,1,6,0.08333333333333333
2019-05-25,Delaware,3,1,0,4,0.75
2019-05-25,Florida,1,2,3,6,0.41666666666666663
2019-05-25,Massachusetts,7,1,4,12,0.75
2019-05-25,Colorado,0,2,4,6,0.3333333333333333
2019-05-25,Missouri,0,0,2,2,0.5
2019-05-25,Georgia,1,3,2,6,0.3333333333333333
2019-05-25,Maryland,0,0,1,1,0.5
2019-05-25,Alabama,2,5,3,10,0.35
2019-05-25,Michigan,0,0,1,1,0.5
2019-05-25,Arkansas,3,3,4,10,0.5
2019-05-25,Nevada,0,0,1,1,0.5
2019-05-25,Louisiana,2,2,2,6,0.5
2019-05-25,Nebraska,1,3,0,4,0.25
2019-05-25,Texas,1,1,2,4,0.5
2019-05-25,Arizona,0,1,3,4,0.375
2019-05-25,Hawaii,2,1,3,6,0.5833333333333333
2019-05-25,Washington,0,0,1,1,0.5
2019-05-25,Alaska,5,1,2,8,0.75
2019-05-25,Maine,0,0,1,1,0.5
2019-05-25,New Jersey,0,1,0,1,0.0
2019-05-25,Indiana,2,1,1,4,0.625
2019-05-25,Iowa,1,0,1,2,0.75
2019-05-25,Kansas,0,0,2,2,0.5
2019-05-25,Oklahoma,1,0,0,1,1.0
2019-05-24,Alabama,1,1,3,5,0.5
2019-05-24,Minnesota,0,1,0,1,0.0
2019-05-24,California,12,8,6,26,0.576923076923077
2019-05-24,Massachusetts,14,4,6,24,0.7083333333333334
2019-05-24,Alaska,4,1,2,7,0.7142857142857142
2019-05-24,Maryland,0,1,3,4,0.375
2019-05-24,Indiana,2,0,9,11,0.5909090909090909
2019-05-24,Nebraska,3,0,4,7,0.7142857142857142
2019-05-24,Arkansas,4,2,2,8,0.625
2019-05-24,Delaware,2,2,1,5,0.5
2019-05-24,Utah,0,1,0,1,0.0
2019-05-24,Georgia,3,0,7,10,0.6499999999999999
2019-05-24,New York,5,3,2,10,0.6
2019-05-24,Washington,1,0,1,2,0.75
2019-05-24,Hawaii,9,3,4,16,0.6875
2019-05-24,Illinois,0,0,3,3,0.5
2019-05-24,New Jersey,0,2,1,3,0.16666666666666666
2019-05-24,Florida,2,0,0,2,1.0
2019-05-24,Louisiana,2,1,1,4,0.625
2019-05-24,Colorado,0,0,2,2,0.5
2019-05-24,Missouri,0,1,1,2,0.25
2019-05-24,Texas,1,1,1,3,0.5
2019-05-24,Iowa,1,0,1,2,0.75
2019-05-24,North Dakota,0,0,1,1,0.5
2019-05-24,Arizona,0,0,1,1,0.5
2019-05-23,Hawaii,2,4,5,11,0.40909090909090906
2019-05-23,North Dakota,0,1,0,1,0.0
2019-05-23,Alabama,5,0,5,10,0.75
2019-05-23,Arizona,5,1,4,10,0.7
2019-05-23,California,2,6,8,16,0.375
2019-05-23,Illinois,0,1,2,3,0.3333333333333333
2019-05-23,Indiana,1,2,2,5,0.4
2019-05-23,Arkansas,3,2,2,7,0.5714285714285714
2019-05-23,Colorado,0,1,2,3,0.3333333333333333
2019-05-23,Georgia,1,2,6,9,0.4444444444444444
2019-05-23,New York,4,0,0,4,1.0
2019-05-23,Delaware,0,1,3,4,0.375
2019-05-23,Kansas,1,2,0,3,0.3333333333333333
2019-05-23,Florida,3,0,0,3,1.0
2019-05-23,Alaska,3,1,0,4,0.75
2019-05-23,Idaho,1,1,0,2,0.5
2019-05-23,Washington,1,1,0,2,0.5
2019-05-23,Massachusetts,3,3,3,9,0.5
2019-05-23,Maryland,0,0,1,1,0.5
2019-05-23,Texas,0,1,2,3,0.3333333333333333
2019-05-23,Nebraska,1,1,1,3,0.5
2019-05-23,Louisiana,1,2,2,5,0.4
2019-05-23,Mississippi,1,0,0,1,1.0
2019-05-23,Ohio,1,0,0,1,1.0
2019-05-23,North Carolina,1,0,1,2,0.75
2019-05-23,New Jersey,0,0,1,1,0.5
2019-05-23,Michigan,1,0,0,1,1.0
2019-05-23,Iowa,0,0,1,1,0.5
2019-05-22,Missouri,0,1,4,5,0.4
2019-05-22,Alaska,3,0,1,4,0.875
2019-05-22,Michigan,0,0,1,1,0.5
2019-05-22,Arizona,2,2,2,6,0.5
2019-05-22,Arkansas,1,2,6,9,0.4444444444444444
2019-05-22,Oregon,0,1,0,1,0.0
2019-05-22,Louisiana,5,1,1,7,0.7857142857142857
2019-05-22,Kansas,2,1,2,5,0.6000000000000001
2019-05-22,Hawaii,4,2,1,7,0.6428571428571428
2019-05-22,Alabama,2,1,5,8,0.5625
2019-05-22,California,12,9,15,36,0.5416666666666666
2019-05-22,Indiana,2,4,1,7,0.3571428571428571
2019-05-22,Massachusetts,4,1,3,8,0.6875
2019-05-22,Georgia,0,2,5,7,0.35714285714285715
2019-05-22,Nebraska,1,1,1,3,0.5
2019-05-22,Texas,2,2,3,7,0.5
2019-05-22,Maryland,0,0,2,2,0.5
2019-05-22,Rhode Island,1,0,0,1,1.0
2019-05-22,Tennessee,0,0,1,1,0.5
2019-05-22,New York,2,1,2,5,0.6000000000000001
2019-05-22,Connecticut,0,0,1,1,0.5
2019-05-22,Delaware,0,1,1,2,0.25
2019-05-22,Ohio,0,3,1,4,0.125
2019-05-22,Colorado,4,0,3,7,0.7857142857142857
2019-05-22,Florida,2,0,2,4,0.75
2019-05-22,Virginia,1,0,0,1,1.0
2019-05-22,Washington,2,0,0,2,1.0
2019-05-22,Idaho,0,0,1,1,0.5
2019-05-22,Illinois,0,1,1,2,0.25
2019-05-21,Illinois,1,5,3,9,0.2777777777777778
2019-05-21,California,3,7,9,19,0.39473684210526316
2019-05-21,Kansas,0,0,3,3,0.5
2019-05-21,Colorado,2,6,9,17,0.38235294117647056
2019-05-21,Alaska,6,1,5,12,0.7083333333333334
2019-05-21,Massachusetts,4,0,7,11,0.6818181818181819
2019-05-21,Florida,1,2,1,4,0.375
2019-05-21,Ohio,0,1,1,2,0.25
2019-05-21,Nebraska,0,0,1,1,0.5
2019-05-21,Indiana,5,0,3,8,0.8125
2019-05-21,New York,1,2,4,7,0.42857142857142855
2019-05-21,Louisiana,2,0,0,2,1.0
2019-05-21,Alabama,3,3,7,13,0.5
2019-05-21,Arkansas,0,2,1,3,0.16666666666666666
2019-05-21,Hawaii,0,2,1,3,0.16666666666666666
2019-05-21,Texas,2,0,2,4,0.75
2019-05-21,Iowa,1,0,4,5,0.6000000000000001
2019-05-21,Washington,1,0,0,1,1.0
2019-05-21,Maryland,0,0,1,1,0.5
2019-05-21,Idaho,1,0,0,1,1.0
2019-05-21,Connecticut,3,1,0,4,0.75
2019-05-21,Oregon,1,0,0,1,1.0
2019-05-21,Delaware,0,1,0,1,0.0
2019-05-21,Michigan,0,0,1,1,0.5
2019-05-21,New Mexico,1,0,0,1,1.0
2019-05-21,Arizona,1,0,0,1,1.0
2019-05-21,Nevada,0,0,1,1,0.5
2019-05-21,New Jersey,0,0,1,1,0.5
2019-05-20,Arkansas,4,2,6,12,0.5833333333333333
2019-05-20,Louisiana,5,4,1,10,0.55
2019-05-20,California,15,9,7,31,0.5967741935483871
2019-05-20,Alabama,3,7,8,18,0.38888888888888884
2019-05-20,Indiana,2,6,5,13,0.34615384615384615
2019-05-20,Illinois,2,1,2,5,0.6000000000000001
2019-05-20,Colorado,1,1,4,6,0.5
2019-05-20,Delaware,2,1,2,5,0.6000000000000001
2019-05-20,Hawaii,1,2,1,4,0.375
2019-05-20,Kansas,1,0,0,1,1.0
2019-05-20,Florida,0,2,1,3,0.16666666666666666
2019-05-20,Arizona,2,1,4,7,0.5714285714285714
2019-05-20,Georgia,0,1,3,4,0.375
2019-05-20,Massachusetts,4,1,2,7,0.7142857142857142
2019-05-20,New York,0,1,3,4,0.375
2019-05-20,Texas,0,0,3,3,0.5
2019-05-20,Michigan,0,1,0,1,0.0
2019-05-20,Pennsylvania,1,0,1,2,0.75
2019-05-20,Alaska,5,0,3,8,0.8125
2019-05-20,Nebraska,0,1,1,2,0.25
2019-05-20,Maryland,3,0,3,6,0.75
2019-05-20,Washington,1,1,0,2,0.5
2019-05-20,Iowa,1,1,0,2,0.5
2019-05-20,Idaho,1,1,0,2,0.5
2019-05-20,Virginia,1,0,0,1,1.0
2019-05-20,Rhode Island,0,0,1,1,0.5
2019-05-19,California,6,9,9,24,0.4375
2019-05-19,Indiana,3,2,1,6,0.5833333333333334
2019-05-19,Alabama,3,1,1,5,0.7
2019-05-19,Massachusetts,4,3,1,8,0.5625
2019-05-19,Hawaii,1,0,3,4,0.625
2019-05-19,Arkansas,2,3,6,11,0.45454545454545453
2019-05-19,Delaware,1,1,3,5,0.5
2019-05-19,Connecticut,1,0,0,1,1.0
2019-05-19,Alaska,0,2,1,3,0.16666666666666666
2019-05-19,New York,1,0,1,2,0.75
2019-05-19,Colorado,2,0,0,2,1.0
2019-05-19,Arizona,1,0,0,1,1.0
2019-05-19,Louisiana,1,0,0,1,1.0
2019-05-19,Maryland,0,1,0,1,0.0
2019-05-19,Florida,0,4,1,5,0.1
2019-05-19,Missouri,0,1,0,1,0.0
2019-05-19,Idaho,0,0,1,1,0.5
2019-05-19,Texas,0,0,2,2,0.5
2019-05-19,Michigan,0,0,2,2,0.5
2019-05-19,Illinois,1,1,1,3,0.5
2019-05-19,Ohio,0,1,0,1,0.0
2019-05-19,Utah,0,0,1,1,0.5
2019-05-19,Georgia,0,0,1,1,0.5
2019-05-18,Georgia,2,1,3,6,0.5833333333333333
2019-05-18,California,7,5,6,18,0.5555555555555556
2019-05-18,Arizona,1,2,1,4,0.375
2019-05-18,Massachusetts,2,1,4,7,0.5714285714285714
2019-05-18,Indiana,1,1,3,5,0.5
2019-05-18,Hawaii,2,1,3,6,0.5833333333333333
2019-05-18,Nebraska,1,2,0,3,0.3333333333333333
2019-05-18,Louisiana,1,0,2,3,0.6666666666666666
2019-05-18,Arkansas,5,1,7,13,0.6538461538461539
2019-05-18,Michigan,0,1,1,2,0.25
2019-05-18,Alabama,3,2,3,8,0.5625
2019-05-18,Florida,1,0,0,1,1.0
2019-05-18,Washington,1,2,0,3,0.3333333333333333
2019-05-18,New York,0,1,1,2,0.25
2019-05-18,Colorado,2,1,1,4,0.625
2019-05-18,Alaska,0,0,3,3,0.5
2019-05-18,North Carolina,1,0,0,1,1.0
2019-05-18,Illinois,0,0,2,2,0.5
2019-05-18,Idaho,1,0,0,1,1.0
2019-05-18,Oregon,0,1,0,1,0.0
2019-05-18,Iowa,0,0,1,1,0.5
2019-05-18,Missouri,0,1,1,2,0.25
2019-05-18,Delaware,0,0,1,1,0.5
2019-05-18,Kansas,0,0,1,1,0.5
2019-05-18,Maine,0,0,1,1,0.5
2019-05-17,California,8,4,6,18,0.611111111111111
2019-05-17,Hawaii,5,2,9,16,0.59375
2019-05-17,Pennsylvania,0,1,1,2,0.25
2019-05-17,Massachusetts,5,2,7,14,0.6071428571428572
2019-05-17,New York,3,1,4,8,0.625
2019-05-17,Florida,3,1,2,6,0.6666666666666666
2019-05-17,Delaware,2,0,0,2,1.0
2019-05-17,Alabama,4,2,6,12,0.5833333333333333
2019-05-17,Colorado,2,2,3,7,0.5
2019-05-17,Nebraska,1,0,0,1,1.0
2019-05-17,Alaska,1,1,1,3,0.5
2019-05-17,Idaho,1,1,1,3,0.5
2019-05-17,Indiana,3,1,2,6,0.6666666666666666
2019-05-17,Arkansas,3,3,4,10,0.5
2019-05-17,Texas,1,1,2,4,0.5
2019-05-17,Illinois,0,0,2,2,0.5
2019-05-17,Washington,0,2,1,3,0.16666666666666666
2019-05-17,Maryland,0,0,2,2,0.5
2019-05-17,Ohio,1,0,0,1,1.0
2019-05-17,Georgia,1,0,0,1,1.0
2019-05-17,Kentucky,0,0,2,2,0.5
2019-05-17,Iowa,0,0,2,2,0.5
2019-05-17,New Jersey,0,0,1,1,0.5
2019-05-17,Virginia,1,0,0,1,1.0
2019-05-17,Louisiana,1,1,1,3,0.5
2019-05-17,Kansas,0,1,0,1,0.0
2019-05-17,Minnesota,0,1,0,1,0.0
2019-05-16,New York,1,2,5,8,0.4375
2019-05-16,Arkansas,6,1,5,12,0.7083333333333334
2019-05-16,California,11,3,17,31,0.6290322580645161
2019-05-16,Michigan,0,0,2,2,0.5
2019-05-16,Massachusetts,5,2,4,11,0.6363636363636364
2019-05-16,Alabama,1,3,5,9,0.3888888888888889
2019-05-16,Nebraska,0,1,0,1,0.0
2019-05-16,Hawaii,4,3,4,11,0.5454545454545454
2019-05-16,Delaware,2,0,1,3,0.8333333333333333
2019-05-16,Florida,7,2,3,12,0.7083333333333334
2019-05-16,Colorado,0,1,6,7,0.42857142857142855
2019-05-16,Missouri,1,0,0,1,1.0
2019-05-16,Arizona,1,0,3,4,0.625
2019-05-16,Connecticut,0,0,1,1,0.5
2019-05-16,Iowa,0,2,1,3,0.16666666666666666
2019-05-16,Texas,1,1,0,2,0.5
2019-05-16,Louisiana,0,2,1,3,0.16666666666666666
2019-05-16,Alaska,2,0,0,2,1.0
2019-05-16,Washington,1,0,0,1,1.0
2019-05-16,Indiana,1,1,1,3,0.5
2019-05-16,South Carolina,0,0,1,1,0.5
2019-05-16,Minnesota,0,0,1,1,0.5
2019-05-16,Illinois,0,1,1,2,0.25
2019-05-16,Kentucky,1,1,0,2,0.5
2019-05-16,New Jersey,1,0,1,2,0.75
2019-05-16,Kansas,1,0,0,1,1.0
2019-05-16,Georgia,0,1,1,2,0.25
2019-05-15,Colorado,3,0,3,6,0.75
2019-05-15,Alaska,1,0,2,3,0.6666666666666666
2019-05-15,California,10,6,10,26,0.576923076923077
2019-05-15,Florida,1,4,3,8,0.3125
2019-05-15,Massachusetts,3,3,6,12,0.5
2019-05-15,Indiana,3,4,8,15,0.4666666666666667
2019-05-15,Alabama,2,7,6,15,0.33333333333333337
2019-05-15,Ohio,1,1,1,3,0.5
2019-05-15,Oklahoma,0,0,1,1,0.5
2019-05-15,Louisiana,3,2,0,5,0.6
2019-05-15,Hawaii,2,4,3,9,0.38888888888888884
2019-05-15,Arkansas,4,9,5,18,0.3611111111111111
2019-05-15,New York,4,2,3,9,0.611111111111111
2019-05-15,Illinois,2,0,5,7,0.6428571428571428
2019-05-15,Nebraska,1,3,0,4,0.25
2019-05-15,Michigan,0,1,0,1,0.0
2019-05-15,Washington,0,1,2,3,0.3333333333333333
2019-05-15,Delaware,0,0,5,5,0.5
2019-05-15,Arizona,1,1,1,3,0.5
2019-05-15,New Jersey,0,1,1,2,0.25
2019-05-15,Oregon,1,0,1,2,0.75
2019-05-15,Texas,1,0,1,2,0.75
2019-05-15,Iowa,0,1,0,1,0.0
2019-05-15,Idaho,1,0,0,1,1.0
2019-05-15,Georgia,0,0,1,1,0.5
2019-05-15,Missouri,0,1,1,2,0.25
2019-05-15,Rhode Island,1,0,0,1,1.0
2019-05-14,Illinois,3,4,6,13,0.46153846153846156
2019-05-14,Massachusetts,11,5,9,25,0.62
2019-05-14,California,11,9,9,29,0.5344827586206896
2019-05-14,Connecticut,0,3,1,4,0.125
2019-05-14,Arkansas,4,5,11,20,0.47500000000000003
2019-05-14,New York,3,5,6,14,0.42857142857142855
2019-05-14,Florida,3,4,5,12,0.45833333333333337
2019-05-14,Iowa,0,7,2,9,0.1111111111111111
2019-05-14,Maryland,1,0,0,1,1.0
2019-05-14,Maine,0,0,1,1,0.5
2019-05-14,Alaska,3,2,3,8,0.5625
2019-05-14,Alabama,3,2,7,12,0.5416666666666667
2019-05-14,Hawaii,5,1,0,6,0.8333333333333334
2019-05-14,Wisconsin,0,2,0,2,0.0
2019-05-14,Colorado,1,3,3,7,0.3571428571428571
2019-05-14,Idaho,3,0,0,3,1.0
2019-05-14,Georgia,4,1,4,9,0.6666666666666666
2019-05-14,Texas,0,1,4,5,0.4
2019-05-14,Indiana,4,4,6,14,0.5
2019-05-14,New Jersey,1,0,0,1,1.0
2019-05-14,Louisiana,4,0,1,5,0.9
2019-05-14,Delaware,4,1,3,8,0.6875
2019-05-14,Michigan,2,1,1,4,0.625
2019-05-14,Missouri,2,2,3,7,0.5
2019-05-14,West Virginia,0,0,1,1,0.5
2019-05-14,Arizona,0,0,4,4,0.5
2019-05-14,Oregon,0,1,4,5,0.4
2019-05-14,Pennsylvania,1,1,0,2,0.5
2019-05-14,New Hampshire,0,1,0,1,0.0
2019-05-14,Washington,1,0,2,3,0.6666666666666666
2019-05-14,Ohio,1,0,1,2,0.75
2019-05-14,Virginia,0,0,1,1,0.5
2019-05-14,New Mexico,1,1,0,2,0.5
2019-05-14,Nebraska,2,1,0,3,0.6666666666666666
2019-05-14,Kentucky,1,0,2,3,0.6666666666666666
2019-05-13,North Carolina,2,0,1,3,0.8333333333333333
2019-05-13,Indiana,8,3,6,17,0.6470588235294118
2019-05-13,California,8,12,16,36,0.4444444444444444
2019-05-13,Alabama,3,4,6,13,0.46153846153846156
2019-05-13,New York,3,2,4,9,0.5555555555555556
2019-05-13,Alaska,1,0,2,3,0.6666666666666666
2019-05-13,Arkansas,6,5,5,16,0.53125
2019-05-13,Hawaii,22,9,13,44,0.6477272727272727
2019-05-13,Missouri,4,0,0,4,1.0
2019-05-13,Georgia,2,3,3,8,0.4375
2019-05-13,Florida,1,3,2,6,0.3333333333333333
2019-05-13,Louisiana,3,3,7,13,0.5
2019-05-13,Delaware,2,0,3,5,0.7
2019-05-13,Nebraska,0,2,2,4,0.25
2019-05-13,New Jersey,1,0,4,5,0.6000000000000001
2019-05-13,Massachusetts,5,11,2,18,0.33333333333333337
2019-05-13,Texas,1,1,4,6,0.5
2019-05-13,Colorado,3,6,1,10,0.35
2019-05-13,Illinois,1,3,2,6,0.3333333333333333
2019-05-13,Maryland,1,0,1,2,0.75
2019-05-13,Oregon,2,1,0,3,0.6666666666666666
2019-05-13,Michigan,1,0,0,1,1.0
2019-05-13,Iowa,0,0,1,1,0.5
2019-05-13,Washington,1,0,1,2,0.75
2019-05-13,Arizona,1,0,0,1,1.0
2019-05-13,Ohio,0,1,0,1,0.0
2019-05-13,Kansas,0,1,0,1,0.0
2019-05-13,Nevada,0,0,1,1,0.5
2019-05-13,Minnesota,2,0,0,2,1.0
2019-05-12,New Jersey,0,0,2,2,0.5
2019-05-12,Colorado,1,2,2,5,0.4
2019-05-12,Nevada,1,0,0,1,1.0
2019-05-12,Hawaii,1,4,2,7,0.2857142857142857
2019-05-12,Ohio,1,1,0,2,0.5
2019-05-12,Georgia,0,2,0,2,0.0
2019-05-12,Iowa,0,0,1,1,0.5
2019-05-12,Louisiana,0,1,1,2,0.25
2019-05-12,Illinois,0,1,1,2,0.25
2019-05-12,South Carolina,0,1,0,1,0.0
2019-05-12,California,3,0,4,7,0.7142857142857142
2019-05-12,New York,1,2,0,3,0.3333333333333333
2019-05-12,Alabama,2,0,0,2,1.0
2019-05-12,Maryland,0,1,0,1,0.0
2019-05-12,Indiana,0,0,1,1,0.5
2019-05-12,Arkansas,1,3,4,8,0.375
2019-05-12,Kansas,1,0,3,4,0.625
2019-05-12,Delaware,1,1,1,3,0.5
2019-05-12,Alaska,0,2,2,4,0.25
2019-05-12,Texas,0,1,0,1,0.0
2019-05-12,Massachusetts,0,0,2,2,0.5
2019-05-12,Virginia,0,1,0,1,0.0
2019-05-12,Florida,1,0,1,2,0.75
2019-05-12,Kentucky,0,1,0,1,0.0
2019-05-12,Oregon,0,1,0,1,0.0
2019-05-12,Connecticut,0,2,0,2,0.0
2019-05-12,Nebraska,0,0,1,1,0.5
2019-05-12,Idaho,1,0,1,2,0.75
2019-05-11,Delaware,3,2,3,8,0.5625
2019-05-11,Georgia,0,1,2,3,0.3333333333333333
2019-05-11,Louisiana,3,1,1,5,0.7
2019-05-11,Alabama,3,3,5,11,0.5
2019-05-11,Kansas,0,0,2,2,0.5
2019-05-11,California,12,3,8,23,0.6956521739130435
2019-05-11,Missouri,0,0,2,2,0.5
2019-05-11,Massachusetts,3,2,2,7,0.5714285714285714
2019-05-11,Illinois,1,2,3,6,0.41666666666666663
2019-05-11,Indiana,1,3,1,5,0.30000000000000004
2019-05-11,Hawaii,3,2,2,7,0.5714285714285714
2019-05-11,Arkansas,1,4,2,7,0.2857142857142857
2019-05-11,Florida,1,2,0,3,0.3333333333333333
2019-05-11,Nebraska,0,1,2,3,0.3333333333333333
2019-05-11,Rhode Island,0,1,0,1,0.0
2019-05-11,New York,0,2,2,4,0.25
2019-05-11,Minnesota,1,0,0,1,1.0
2019-05-11,Idaho,1,0,0,1,1.0
2019-05-11,Alaska,0,0,1,1,0.5
2019-05-11,Iowa,0,0,1,1,0.5
2019-05-10,Indiana,3,3,3,9,0.5
2019-05-10,Hawaii,4,2,4,10,0.6000000000000001
2019-05-10,California,11,5,7,23,0.6304347826086957
2019-05-10,Minnesota,0,0,1,1,0.5
2019-05-10,Delaware,1,2,1,4,0.375
2019-05-10,New York,1,2,3,6,0.41666666666666663
2019-05-10,Texas,0,1,4,5,0.4
2019-05-10,Arkansas,3,5,2,10,0.4
2019-05-10,North Carolina,0,0,1,1,0.5
2019-05-10,Florida,2,2,2,6,0.5
2019-05-10,Alabama,2,1,5,8,0.5625
2019-05-10,Illinois,2,2,1,5,0.5
2019-05-10,Arizona,1,0,0,1,1.0
2019-05-10,Massachusetts,4,1,8,13,0.6153846153846154
2019-05-10,Idaho,0,0,1,1,0.5
2019-05-10,Vermont,0,0,1,1,0.5
2019-05-10,Colorado,1,0,2,3,0.6666666666666666
2019-05-10,Nebraska,0,1,1,2,0.25
2019-05-10,Alaska,0,3,0,3,0.0
2019-05-10,Ohio,0,1,0,1,0.0
2019-05-10,Virginia,0,1,1,2,0.25
2019-05-10,Georgia,0,0,1,1,0.5
2019-05-10,Oregon,0,0,1,1,0.5
2019-05-10,Pennsylvania,0,1,0,1,0.0
2019-05-10,Louisiana,1,0,1,2,0.75
2019-05-10,West Virginia,1,0,0,1,1.0
2019-05-10,Missouri,0,0,1,1,0.5
2019-05-09,Indiana,1,2,5,8,0.4375
2019-05-09,Illinois,2,0,0,2,1.0
2019-05-09,Alabama,3,2,2,7,0.5714285714285714
2019-05-09,Texas,2,1,2,5,0.6000000000000001
2019-05-09,New York,0,0,4,4,0.5
2019-05-09,Louisiana,1,1,1,3,0.5
2019-05-09,California,5,6,5,16,0.46875
2019-05-09,Hawaii,1,1,1,3,0.5
2019-05-09,Missouri,1,0,0,1,1.0
2019-05-09,Massachusetts,3,1,5,9,0.6111111111111112
2019-05-09,Nebraska,1,2,0,3,0.3333333333333333
2019-05-09,Alaska,1,0,1,2,0.75
2019-05-09,Delaware,3,0,0,3,1.0
2019-05-09,Colorado,1,3,5,9,0.3888888888888889
2019-05-09,Arkansas,2,2,3,7,0.5
2019-05-09,Georgia,1,0,2,3,0.6666666666666666
2019-05-09,Kansas,1,1,2,4,0.5
2019-05-09,New Jersey,0,0,2,2,0.5
2019-05-09,Virginia,0,1,0,1,0.0
2019-05-09,Michigan,0,0,2,2,0.5
2019-05-09,Florida,2,1,0,3,0.6666666666666666
2019-05-09,Minnesota,0,0,1,1,0.5
2019-05-09,Iowa,0,1,1,2,0.25
2019-05-09,Oklahoma,0,0,1,1,0.5
2019-05-09,Arizona,0,1,0,1,0.0
2019-05-09,Pennsylvania,0,1,0,1,0.0
2019-05-09,Maryland,0,0,1,1,0.5
2019-05-08,California,6,4,4,14,0.5714285714285714
2019-05-08,North Dakota,0,0,1,1,0.5
2019-05-08,Indiana,1,2,4,7,0.42857142857142855
2019-05-08,Minnesota,1,0,0,1,1.0
2019-05-08,Michigan,1,0,2,3,0.6666666666666666
2019-05-08,Oregon,1,0,1,2,0.75
2019-05-08,New Mexico,0,0,1,1,0.5
2019-05-08,Washington,3,1,4,8,0.625
2019-05-08,Delaware,1,0,0,1,1.0
2019-05-08,Hawaii,0,0,4,4,0.5
2019-05-08,Massachusetts,1,1,2,4,0.5
2019-05-08,Virginia,0,0,1,1,0.5
2019-05-08,New Jersey,0,0,1,1,0.5
2019-05-08,Louisiana,3,1,0,4,0.75
2019-05-08,Alabama,2,0,6,8,0.625
2019-05-08,Colorado,3,1,1,5,0.7
2019-05-08,Missouri,1,0,0,1,1.0
2019-05-08,Arizona,0,2,0,2,0.0
2019-05-08,Texas,1,0,2,3,0.6666666666666666
2019-05-08,Florida,2,3,0,5,0.4
2019-05-08,Arkansas,1,3,3,7,0.3571428571428571
2019-05-08,Nebraska,4,0,0,4,1.0
2019-05-08,New York,1,0,1,2,0.75
2019-05-08,Georgia,1,1,1,3,0.5
2019-05-08,Rhode Island,0,1,0,1,0.0
2019-05-08,Connecticut,1,1,0,2,0.5
2019-05-08,Illinois,1,0,0,1,1.0
2019-05-08,Idaho,1,0,0,1,1.0
2019-05-08,Iowa,1,1,0,2,0.5
2019-05-08,Alaska,1,0,2,3,0.6666666666666666
2019-05-08,Maryland,0,0,1,1,0.5
2019-05-07,Colorado,2,1,2,5,0.6000000000000001
2019-05-07,New York,2,2,2,6,0.5
2019-05-07,Alabama,4,1,4,9,0.6666666666666666
2019-05-07,Indiana,3,0,6,9,0.6666666666666666
2019-05-07,California,14,6,8,28,0.6428571428571428
2019-05-07,Louisiana,10,3,5,18,0.6944444444444444
2019-05-07,Alaska,3,1,2,6,0.6666666666666666
2019-05-07,Georgia,1,2,7,10,0.44999999999999996
2019-05-07,Massachusetts,2,0,3,5,0.7
2019-05-07,New Jersey,1,1,0,2,0.5
2019-05-07,Kansas,1,0,1,2,0.75
2019-05-07,Florida,2,4,7,13,0.4230769230769231
2019-05-07,Tennessee,0,1,0,1,0.0
2019-05-07,Hawaii,2,2,5,9,0.5
2019-05-07,Arkansas,0,4,1,5,0.1
2019-05-07,Washington,1,0,0,1,1.0
2019-05-07,Texas,3,3,1,7,0.5
2019-05-07,Illinois,1,0,3,4,0.625
2019-05-07,Arizona,0,0,2,2,0.5
2019-05-07,Idaho,1,0,1,2,0.75
2019-05-07,Pennsylvania,0,1,0,1,0.0
2019-05-07,Nebraska,2,0,0,2,1.0
2019-05-07,Maryland,1,0,0,1,1.0
2019-05-07,Montana,0,0,1,1,0.5
2019-05-07,Delaware,1,1,0,2,0.5
2019-05-07,Ohio,1,0,1,2,0.75
2019-05-07,Oregon,0,1,0,1,0.0
2019-05-07,Missouri,0,0,1,1,0.5
2019-05-07,Kentucky,0,1,0,1,0.0
2019-05-07,Iowa,1,0,0,1,1.0
2019-05-07,Minnesota,0,1,0,1,0.0
2019-05-06,Florida,2,3,2,7,0.42857142857142855
2019-05-06,Arkansas,1,2,3,6,0.41666666666666663
2019-05-06,Alabama,2,0,3,5,0.7
2019-05-06,Alaska,3,1,0,4,0.75
2019-05-06,Hawaii,4,4,2,10,0.5
2019-05-06,Minnesota,1,1,0,2,0.5
2019-05-06,Delaware,0,2,0,2,0.0
2019-05-06,California,11,5,5,21,0.6428571428571429
2019-05-06,Colorado,2,0,1,3,0.8333333333333333
2019-05-06,Maryland,1,0,0,1,1.0
2019-05-06,Georgia,3,1,0,4,0.75
2019-05-06,Michigan,0,0,2,2,0.5
2019-05-06,Indiana,6,0,2,8,0.875
2019-05-06,Oregon,0,0,2,2,0.5
2019-05-06,Pennsylvania,2,0,1,3,0.8333333333333333
2019-05-06,New York,1,1,6,8,0.5
2019-05-06,Massachusetts,3,3,3,9,0.5
2019-05-06,Ohio,0,0,1,1,0.5
2019-05-06,Missouri,0,0,1,1,0.5
2019-05-06,Kansas,0,1,0,1,0.0
2019-05-06,Louisiana,2,2,1,5,0.5
2019-05-06,Iowa,1,1,0,2,0.5
2019-05-06,Illinois,0,0,1,1,0.5
2019-05-06,Texas,0,3,2,5,0.2
2019-05-06,Nebraska,1,0,0,1,1.0
2019-05-06,Connecticut,1,0,0,1,1.0
2019-05-06,Arizona,0,2,0,2,0.0
2019-05-06,Idaho,1,0,0,1,1.0
2019-05-06,New Jersey,1,0,1,2,0.75
2019-05-06,Maine,0,0,1,1,0.5
2019-05-06,Washington,0,1,0,1,0.0
2019-05-05,Arkansas,2,0,3,5,0.7
2019-05-05,New York,1,0,1,2,0.75
2019-05-05,Iowa,0,1,0,1,0.0
2019-05-05,Hawaii,4,0,2,6,0.8333333333333333
2019-05-05,Alabama,3,3,1,7,0.5
2019-05-05,Kentucky,0,0,1,1,0.5
2019-05-05,California,7,2,2,11,0.7272727272727273
2019-05-05,Illinois,1,1,3,5,0.5
2019-05-05,Massachusetts,0,0,3,3,0.5
2019-05-05,Nebraska,1,0,2,3,0.6666666666666666
2019-05-05,Indiana,0,1,7,8,0.4375
2019-05-05,Florida,3,0,2,5,0.8
2019-05-05,Kansas,0,0,1,1,0.5
2019-05-05,Louisiana,0,1,0,1,0.0
2019-05-05,Idaho,0,0,1,1,0.5
2019-05-05,Texas,1,0,0,1,1.0
2019-05-05,Delaware,0,0,3,3,0.5
2019-05-05,Connecticut,1,0,0,1,1.0
2019-05-05,Georgia,1,1,2,4,0.5
2019-05-05,Alaska,0,1,0,1,0.0
2019-05-04,Texas,1,0,0,1,1.0
2019-05-04,Arkansas,2,0,6,8,0.625
2019-05-04,Colorado,0,4,2,6,0.16666666666666666
2019-05-04,Massachusetts,6,1,2,9,0.7777777777777777
2019-05-04,New Jersey,0,1,0,1,0.0
2019-05-04,Oregon,1,0,0,1,1.0
2019-05-04,Alaska,1,1,1,3,0.5
2019-05-04,Hawaii,0,1,2,3,0.3333333333333333
2019-05-04,Iowa,2,0,1,3,0.8333333333333333
2019-05-04,California,9,5,6,20,0.6
2019-05-04,Alabama,0,1,5,6,0.4166666666666667
2019-05-04,Arizona,0,1,0,1,0.0
2019-05-04,Florida,3,0,0,3,1.0
2019-05-04,Minnesota,1,1,0,2,0.5
2019-05-04,New York,2,1,0,3,0.6666666666666666
2019-05-04,Nebraska,1,1,0,2,0.5
2019-05-04,Washington,1,0,0,1,1.0
2019-05-04,Louisiana,2,0,0,2,1.0
2019-05-04,Kentucky,0,1,1,2,0.25
2019-05-04,Oklahoma,1,0,0,1,1.0
2019-05-04,Indiana,0,1,2,3,0.3333333333333333
2019-05-04,North Carolina,0,1,1,2,0.25
2019-05-04,Mississippi,1,0,0,1,1.0
2019-05-04,Maryland,0,1,0,1,0.0
2019-05-04,Illinois,0,1,1,2,0.25
2019-05-04,Idaho,1,0,0,1,1.0
2019-05-04,Delaware,1,0,0,1,1.0
2019-05-03,California,8,10,11,29,0.46551724137931033
2019-05-03,Massachusetts,3,3,3,9,0.5
2019-05-03,Louisiana,2,1,0,3,0.6666666666666666
2019-05-03,Nebraska,1,0,3,4,0.625
2019-05-03,Alabama,4,2,7,13,0.5769230769230769
2019-05-03,New York,0,1,2,3,0.3333333333333333
2019-05-03,Arizona,1,0,1,2,0.75
2019-05-03,Virginia,0,2,0,2,0.0
2019-05-03,Minnesota,2,0,1,3,0.8333333333333333
2019-05-03,Washington,2,0,2,4,0.75
2019-05-03,Hawaii,2,1,6,9,0.5555555555555556
2019-05-03,Alaska,4,0,0,4,1.0
2019-05-03,North Dakota,1,0,1,2,0.75
2019-05-03,Texas,2,1,1,4,0.625
2019-05-03,Missouri,0,0,4,4,0.5
2019-05-03,Indiana,2,2,2,6,0.5
2019-05-03,Idaho,1,0,1,2,0.75
2019-05-03,Arkansas,1,0,2,3,0.6666666666666666
2019-05-03,Colorado,1,1,1,3,0.5
2019-05-03,Florida,0,3,1,4,0.125
2019-05-03,Michigan,1,0,1,2,0.75
2019-05-03,Illinois,2,0,1,3,0.8333333333333333
2019-05-03,Kansas,2,0,0,2,1.0
2019-05-03,Oregon,1,0,0,1,1.0
2019-05-03,Connecticut,0,1,0,1,0.0
2019-05-02,Washington,2,2,0,4,0.5
2019-05-02,Arkansas,5,4,3,12,0.5416666666666667
2019-05-02,Florida,2,5,2,9,0.3333333333333333
2019-05-02,California,10,12,7,29,0.4655172413793104
2019-05-02,Oregon,0,1,3,4,0.375
2019-05-02,New York,1,4,3,8,0.3125
2019-05-02,Hawaii,7,2,5,14,0.6785714285714286
2019-05-02,Minnesota,0,1,0,1,0.0
2019-05-02,Delaware,1,0,3,4,0.625
2019-05-02,New Jersey,0,0,1,1,0.5
2019-05-02,Nebraska,2,0,0,2,1.0
2019-05-02,Alabama,2,2,5,9,0.5
2019-05-02,Indiana,1,2,4,7,0.42857142857142855
2019-05-02,Connecticut,0,1,0,1,0.0
2019-05-02,Georgia,3,1,0,4,0.75
2019-05-02,Illinois,2,1,0,3,0.6666666666666666
2019-05-02,Arizona,0,0,1,1,0.5
2019-05-02,North Dakota,0,0,1,1,0.5
2019-05-02,Ohio,0,1,0,1,0.0
2019-05-02,Massachusetts,2,4,3,9,0.38888888888888884
2019-05-02,Colorado,5,3,1,9,0.6111111111111112
2019-05-02,Texas,1,0,1,2,0.75
2019-05-02,Louisiana,3,0,0,3,1.0
2019-05-02,Maryland,1,0,0,1,1.0
2019-05-02,Iowa,0,0,1,1,0.5
2019-05-02,Missouri,0,1,0,1,0.0
2019-05-02,Oklahoma,0,0,1,1,0.5
2019-05-01,Washington,1,0,1,2,0.75
2019-05-01,Colorado,3,1,0,4,0.75
2019-05-01,Louisiana,2,1,1,4,0.625
2019-05-01,California,13,7,5,25,0.62
2019-05-01,Alaska,4,1,4,9,0.6666666666666666
2019-05-01,Kansas,0,4,2,6,0.16666666666666666
2019-05-01,Illinois,3,1,3,7,0.6428571428571428
2019-05-01,Massachusetts,2,1,3,6,0.5833333333333333
2019-05-01,Arkansas,7,10,8,25,0.44000000000000006
2019-05-01,New York,3,0,4,7,0.7142857142857142
2019-05-01,Georgia,0,4,1,5,0.1
2019-05-01,Delaware,2,1,2,5,0.6000000000000001
2019-05-01,New Jersey,2,0,1,3,0.8333333333333333
2019-05-01,Connecticut,0,1,1,2,0.25
2019-05-01,Florida,1,1,6,8,0.5
2019-05-01,Indiana,2,2,3,7,0.5
2019-05-01,Texas,0,1,1,2,0.25
2019-05-01,Missouri,1,1,1,3,0.5
2019-05-01,Iowa,0,0,1,1,0.5
2019-05-01,Alabama,1,0,2,3,0.6666666666666666
2019-05-01,Nevada,0,0,1,1,0.5
2019-05-01,Hawaii,3,2,4,9,0.5555555555555556
2019-05-01,Maryland,0,0,1,1,0.5
2019-05-01,Arizona,0,0,2,2,0.5
2019-05-01,Ohio,0,1,0,1,0.0
2019-05-01,Rhode Island,0,0,1,1,0.5
2019-04-30,Indiana,5,7,4,16,0.4375
2019-04-30,Colorado,4,2,3,9,0.611111111111111
2019-04-30,Texas,1,0,3,4,0.625
2019-04-30,Massachusetts,12,20,26,58,0.43103448275862066
2019-04-30,Hawaii,6,1,7,14,0.6785714285714286
2019-04-30,California,9,13,19,41,0.45121951219512196
2019-04-30,Louisiana,0,2,0,2,0.0
2019-04-30,Nebraska,1,2,1,4,0.375
2019-04-30,Kansas,1,0,2,3,0.6666666666666666
2019-04-30,Georgia,1,0,3,4,0.625
2019-04-30,Alabama,2,3,6,11,0.45454545454545453
2019-04-30,Florida,1,0,4,5,0.6000000000000001
2019-04-30,Connecticut,0,1,1,2,0.25
2019-04-30,Illinois,0,0,4,4,0.5
2019-04-30,Arkansas,3,4,2,9,0.4444444444444444
2019-04-30,Arizona,0,1,0,1,0.0
2019-04-30,Delaware,0,1,0,1,0.0
2019-04-30,Alaska,1,3,1,5,0.30000000000000004
2019-04-30,New York,3,3,6,12,0.5
2019-04-30,Iowa,1,1,0,2,0.5
2019-04-30,Missouri,4,0,0,4,1.0
2019-04-30,Ohio,0,1,0,1,0.0
2019-04-30,Idaho,0,0,1,1,0.5
2019-04-30,New Jersey,0,1,0,1,0.0
2019-04-30,Minnesota,0,0,1,1,0.5
2019-04-30,Michigan,0,0,1,1,0.5
2019-04-30,Oklahoma,0,1,0,1,0.0
2019-04-29,Missouri,1,0,1,2,0.75
2019-04-29,Nebraska,2,2,0,4,0.5
2019-04-29,Arkansas,2,4,0,6,0.3333333333333333
2019-04-29,Idaho,1,0,1,2,0.75
2019-04-29,Georgia,1,1,4,6,0.5
2019-04-29,New York,1,0,1,2,0.75
2019-04-29,Arizona,1,0,2,3,0.6666666666666666
2019-04-29,Florida,2,2,4,8,0.5
2019-04-29,California,7,2,4,13,0.6923076923076923
2019-04-29,Texas,0,1,2,3,0.3333333333333333
2019-04-29,Indiana,0,1,2,3,0.3333333333333333
2019-04-29,Colorado,2,2,0,4,0.5
2019-04-29,Alaska,1,2,3,6,0.41666666666666663
2019-04-29,Maryland,0,1,0,1,0.0
2019-04-29,Massachusetts,1,0,1,2,0.75
2019-04-29,North Dakota,0,0,1,1,0.5
2019-04-29,Delaware,2,1,2,5,0.6000000000000001
2019-04-29,Hawaii,0,0,4,4,0.5
2019-04-29,Louisiana,2,1,3,6,0.5833333333333333
2019-04-29,Iowa,0,0,2,2,0.5
2019-04-29,Alabama,1,2,3,6,0.41666666666666663
2019-04-29,New Jersey,0,0,1,1,0.5
2019-04-29,Pennsylvania,0,0,1,1,0.5
2019-04-28,Florida,2,1,4,7,0.5714285714285714
2019-04-28,California,2,7,6,15,0.33333333333333337
2019-04-28,Washington,0,0,1,1,0.5
2019-04-28,Nebraska,2,0,0,2,1.0
2019-04-28,New York,0,2,1,3,0.16666666666666666
2019-04-28,Delaware,0,0,3,3,0.5
2019-04-28,Alaska,0,1,2,3,0.3333333333333333
2019-04-28,Illinois,3,0,0,3,1.0
2019-04-28,Alabama,4,2,7,13,0.5769230769230769
2019-04-28,Iowa,0,1,0,1,0.0
2019-04-28,Arkansas,4,1,6,11,0.6363636363636364
2019-04-28,Arizona,0,1,0,1,0.0
2019-04-28,Kentucky,0,0,1,1,0.5
2019-04-28,Indiana,4,2,10,16,0.5625
2019-04-28,Missouri,1,0,1,2,0.75
2019-04-28,Louisiana,1,0,2,3,0.6666666666666666
2019-04-28,Massachusetts,2,1,1,4,0.625
2019-04-28,Georgia,1,1,2,4,0.5
2019-04-28,Idaho,0,1,0,1,0.0
2019-04-28,Colorado,2,0,2,4,0.75
2019-04-28,Hawaii,1,1,0,2,0.5
2019-04-28,Oregon,1,0,0,1,1.0
2019-04-28,New Jersey,0,0,1,1,0.5
2019-04-28,Wisconsin,0,0,1,1,0.5
2019-04-27,Illinois,2,1,5,8,0.5625
2019-04-27,Hawaii,2,0,1,3,0.8333333333333333
2019-04-27,Michigan,1,0,1,2,0.75
2019-04-27,Texas,1,0,4,5,0.6000000000000001
2019-04-27,California,8,6,12,26,0.5384615384615385
2019-04-27,Alaska,2,1,2,5,0.6000000000000001
2019-04-27,Massachusetts,2,1,4,7,0.5714285714285714
2019-04-27,Florida,2,0,1,3,0.8333333333333333
2019-04-27,Arkansas,4,2,6,12,0.5833333333333333
2019-04-27,Washington,1,0,0,1,1.0
2019-04-27,Alabama,1,3,7,11,0.40909090909090906
2019-04-27,Kentucky,1,0,1,2,0.75
2019-04-27,Arizona,1,1,1,3,0.5
2019-04-27,Indiana,3,3,8,14,0.5
2019-04-27,Nebraska,1,2,2,5,0.4
2019-04-27,Idaho,0,2,1,3,0.16666666666666666
2019-04-27,New York,3,3,2,8,0.5
2019-04-27,Oregon,0,0,1,1,0.5
2019-04-27,Minnesota,1,0,1,2,0.75
2019-04-27,Louisiana,0,1,1,2,0.25
2019-04-27,New Jersey,0,0,1,1,0.5
2019-04-27,Colorado,2,1,0,3,0.6666666666666666
2019-04-27,Connecticut,0,0,1,1,0.5
2019-04-27,South Dakota,0,1,0,1,0.0
2019-04-27,Missouri,3,1,0,4,0.75
2019-04-27,Delaware,1,0,0,1,1.0
2019-04-27,Georgia,0,1,0,1,0.0
2019-04-27,Maryland,0,0,4,4,0.5
2019-04-27,Iowa,0,1,0,1,0.0
2019-04-26,Missouri,1,0,0,1,1.0
2019-04-26,California,7,4,12,23,0.5652173913043479
2019-04-26,Texas,1,1,4,6,0.5
2019-04-26,Florida,0,1,7,8,0.4375
2019-04-26,Arkansas,5,5,5,15,0.5
2019-04-26,Hawaii,1,0,3,4,0.625
2019-04-26,Alabama,4,1,4,9,0.6666666666666666
2019-04-26,Oregon,2,0,0,2,1.0
2019-04-26,Massachusetts,4,2,2,8,0.625
2019-04-26,Colorado,4,3,3,10,0.55
2019-04-26,Louisiana,1,2,3,6,0.41666666666666663
2019-04-26,Delaware,2,0,1,3,0.8333333333333333
2019-04-26,Illinois,1,1,2,4,0.5
2019-04-26,Maryland,0,0,1,1,0.5
2019-04-26,Nebraska,1,0,1,2,0.75
2019-04-26,Utah,0,0,1,1,0.5
2019-04-26,Oklahoma,0,0,1,1,0.5
2019-04-26,Wisconsin,0,0,1,1,0.5
2019-04-26,Indiana,2,2,1,5,0.5
2019-04-26,Michigan,0,0,3,3,0.5
2019-04-26,New York,2,2,1,5,0.5
2019-04-26,Connecticut,1,0,0,1,1.0
2019-04-26,Alaska,1,2,1,4,0.375
2019-04-26,Iowa,0,1,1,2,0.25
2019-04-26,New Hampshire,0,0,1,1,0.5
2019-04-26,Arizona,0,0,1,1,0.5
2019-04-26,Georgia,0,1,0,1,0.0
2019-04-25,Texas,2,2,0,4,0.5
2019-04-25,Massachusetts,2,2,5,9,0.5
2019-04-25,Delaware,1,0,2,3,0.6666666666666666
2019-04-25,Oklahoma,0,0,1,1,0.5
2019-04-25,Illinois,3,2,2,7,0.5714285714285714
2019-04-25,Indiana,2,0,2,4,0.75
2019-04-25,New York,0,0,1,1,0.5
2019-04-25,Arizona,1,0,0,1,1.0
2019-04-25,California,7,3,9,19,0.6052631578947368
2019-04-25,Alabama,4,1,6,11,0.6363636363636364
2019-04-25,Arkansas,3,2,3,8,0.5625
2019-04-25,Louisiana,1,0,2,3,0.6666666666666666
2019-04-25,Nebraska,1,2,7,10,0.44999999999999996
2019-04-25,Minnesota,0,1,0,1,0.0
2019-04-25,Colorado,1,0,4,5,0.6000000000000001
2019-04-25,Georgia,2,1,3,6,0.5833333333333333
2019-04-25,Oregon,0,0,1,1,0.5
2019-04-25,Kansas,0,1,0,1,0.0
2019-04-25,Washington,1,1,1,3,0.5
2019-04-25,Missouri,1,0,1,2,0.75
2019-04-25,Iowa,1,0,1,2,0.75
2019-04-25,Hawaii,3,1,3,7,0.6428571428571428
2019-04-25,Alaska,0,1,2,3,0.3333333333333333
2019-04-25,Michigan,0,1,0,1,0.0
2019-04-25,Maine,0,1,0,1,0.0
2019-04-25,Ohio,0,1,0,1,0.0
2019-04-25,Florida,1,1,4,6,0.5
2019-04-25,Idaho,0,0,1,1,0.5
2019-04-25,Maryland,1,0,1,2,0.75
2019-04-25,Pennsylvania,0,0,1,1,0.5
2019-04-24,Texas,1,0,3,4,0.625
2019-04-24,Indiana,2,2,1,5,0.5
2019-04-24,California,17,14,10,41,0.5365853658536586
2019-04-24,Iowa,2,2,0,4,0.5
2019-04-24,Massachusetts,8,1,4,13,0.7692307692307693
2019-04-24,New York,1,1,1,3,0.5
2019-04-24,Arkansas,3,2,9,14,0.5357142857142857
2019-04-24,Georgia,1,1,3,5,0.5
2019-04-24,Hawaii,1,4,2,7,0.2857142857142857
2019-04-24,Washington,1,0,2,3,0.6666666666666666
2019-04-24,Colorado,2,2,1,5,0.5
2019-04-24,Utah,0,1,0,1,0.0
2019-04-24,Alaska,1,0,1,2,0.75
2019-04-24,Virginia,1,0,0,1,1.0
2019-04-24,Illinois,7,0,2,9,0.8888888888888888
2019-04-24,Florida,1,0,1,2,0.75
2019-04-24,Nebraska,0,1,0,1,0.0
2019-04-24,Alabama,3,1,1,5,0.7
2019-04-24,Delaware,1,1,0,2,0.5
2019-04-24,Pennsylvania,0,1,3,4,0.375
2019-04-24,Louisiana,1,0,2,3,0.6666666666666666
2019-04-24,Kansas,1,0,0,1,1.0
2019-04-24,Arizona,0,0,1,1,0.5
2019-04-24,Missouri,0,1,0,1,0.0
2019-04-24,Oregon,0,0,1,1,0.5
2019-04-24,Idaho,1,0,0,1,1.0
2019-04-23,Alabama,0,3,7,10,0.35
2019-04-23,Massachusetts,10,2,5,17,0.7352941176470589
2019-04-23,Florida,1,1,4,6,0.5
2019-04-23,Indiana,5,7,4,16,0.4375
2019-04-23,Michigan,0,0,1,1,0.5
2019-04-23,California,6,2,15,23,0.5869565217391304
2019-04-23,Georgia,1,1,1,3,0.5
2019-04-23,Washington,1,1,0,2,0.5
2019-04-23,Maryland,0,0,1,1,0.5
2019-04-23,Hawaii,2,1,5,8,0.5625
2019-04-23,Missouri,3,0,0,3,1.0
2019-04-23,Nebraska,1,3,2,6,0.3333333333333333
2019-04-23,Louisiana,4,1,3,8,0.6875
2019-04-23,Arkansas,7,3,2,12,0.6666666666666667
2019-04-23,Oregon,0,1,0,1,0.0
2019-04-23,Utah,0,0,1,1,0.5
2019-04-23,Ohio,0,0,1,1,0.5
2019-04-23,Pennsylvania,1,0,1,2,0.75
2019-04-23,Arizona,1,0,1,2,0.75
2019-04-23,New York,1,1,4,6,0.5
2019-04-23,North Dakota,0,0,1,1,0.5
2019-04-23,Maine,1,0,1,2,0.75
2019-04-23,Colorado,3,2,4,9,0.5555555555555556
2019-04-23,Connecticut,0,1,0,1,0.0
2019-04-23,New Hampshire,0,0,1,1,0.5
2019-04-23,Texas,0,1,1,2,0.25
2019-04-23,North Carolina,0,1,0,1,0.0
2019-04-23,New Jersey,1,1,0,2,0.5
2019-04-23,Kentucky,0,0,1,1,0.5
2019-04-22,California,31,14,10,55,0.6545454545454545
2019-04-22,Indiana,5,4,12,21,0.5238095238095237
2019-04-22,Oregon,1,3,3,7,0.3571428571428571
2019-04-22,Arkansas,9,1,6,16,0.75
2019-04-22,New York,2,3,1,6,0.41666666666666663
2019-04-22,Pennsylvania,0,1,2,3,0.3333333333333333
2019-04-22,Massachusetts,10,5,6,21,0.6190476190476191
2019-04-22,Delaware,4,1,3,8,0.6875
2019-04-22,Alabama,8,4,5,17,0.6176470588235294
2019-04-22,Illinois,3,2,3,8,0.5625
2019-04-22,Colorado,5,2,4,11,0.6363636363636364
2019-04-22,Kentucky,1,0,1,2,0.75
2019-04-22,New Jersey,1,0,5,6,0.5833333333333334
2019-04-22,Nebraska,6,3,5,14,0.6071428571428571
2019-04-22,Texas,5,1,4,10,0.7
2019-04-22,New Mexico,1,0,0,1,1.0
2019-04-22,Florida,4,2,2,8,0.625
2019-04-22,Louisiana,5,2,0,7,0.7142857142857143
2019-04-22,Arizona,0,1,2,3,0.3333333333333333
2019-04-22,Georgia,3,2,2,7,0.5714285714285714
2019-04-22,Hawaii,6,3,3,12,0.625
2019-04-22,Alaska,0,2,1,3,0.16666666666666666
2019-04-22,Ohio,0,0,1,1,0.5
2019-04-22,Iowa,2,2,1,5,0.5
2019-04-22,Missouri,0,1,1,2,0.25
2019-04-22,Michigan,2,0,0,2,1.0
2019-04-22,Washington,5,0,0,5,1.0
2019-04-22,Mississippi,0,0,1,1,0.5
2019-04-22,Idaho,0,1,0,1,0.0
2019-04-22,South Carolina,0,1,0,1,0.0
2019-04-22,Kansas,0,0,1,1,0.5
2019-04-22,Connecticut,0,1,0,1,0.0
2019-04-22,Maryland,0,0,1,1,0.5
2019-04-21,Oregon,0,2,0,2,0.0
2019-04-21,California,10,4,4,18,0.6666666666666667
2019-04-21,Massachusetts,1,1,2,4,0.5
2019-04-21,Arkansas,3,3,2,8,0.5
2019-04-21,Alabama,2,3,3,8,0.4375
2019-04-21,Florida,1,2,3,6,0.41666666666666663
2019-04-21,New York,4,2,0,6,0.6666666666666666
2019-04-21,Indiana,1,2,2,5,0.4
2019-04-21,Nebraska,2,0,2,4,0.75
2019-04-21,Kansas,0,0,2,2,0.5
2019-04-21,Hawaii,0,0,1,1,0.5
2019-04-21,Louisiana,3,0,0,3,1.0
2019-04-21,Alaska,1,1,1,3,0.5
2019-04-21,Georgia,0,0,1,1,0.5
2019-04-21,Colorado,0,1,0,1,0.0
2019-04-21,Arizona,1,0,0,1,1.0
2019-04-21,Illinois,0,1,0,1,0.0
2019-04-21,Missouri,0,1,0,1,0.0
2019-04-21,New Jersey,0,1,0,1,0.0
2019-04-20,Indiana,2,4,6,12,0.41666666666666663
2019-04-20,New York,0,0,1,1,0.5
2019-04-20,Georgia,1,0,3,4,0.625
2019-04-20,Texas,2,2,3,7,0.5
2019-04-20,Ohio,0,0,1,1,0.5
2019-04-20,California,6,2,5,13,0.6538461538461539
2019-04-20,Arkansas,0,2,3,5,0.3
2019-04-20,Illinois,1,1,3,5,0.5
2019-04-20,Alabama,0,3,5,8,0.3125
2019-04-20,Alaska,1,1,2,4,0.5
2019-04-20,Massachusetts,5,2,3,10,0.65
2019-04-20,North Dakota,1,0,0,1,1.0
2019-04-20,Arizona,1,1,3,5,0.5
2019-04-20,Delaware,2,1,0,3,0.6666666666666666
2019-04-20,Colorado,2,2,0,4,0.5
2019-04-20,Nebraska,1,0,1,2,0.75
2019-04-20,Iowa,0,1,1,2,0.25
2019-04-20,Virginia,1,0,0,1,1.0
2019-04-20,Hawaii,1,2,1,4,0.375
2019-04-20,Florida,0,1,2,3,0.3333333333333333
2019-04-20,Kansas,0,1,0,1,0.0
2019-04-20,Pennsylvania,0,1,0,1,0.0
2019-04-20,Oklahoma,0,2,0,2,0.0
2019-04-20,Missouri,4,0,1,5,0.9
2019-04-20,Maryland,0,0,1,1,0.5
2019-04-20,Louisiana,1,0,0,1,1.0
2019-04-19,Alabama,3,0,5,8,0.6875
2019-04-19,Indiana,1,0,7,8,0.5625
2019-04-19,Illinois,0,0,2,2,0.5
2019-04-19,Michigan,0,2,1,3,0.16666666666666666
2019-04-19,Washington,0,0,1,1,0.5
2019-04-19,California,10,1,11,22,0.7045454545454546
2019-04-19,Georgia,0,2,1,3,0.16666666666666666
2019-04-19,Hawaii,3,1,5,9,0.6111111111111112
2019-04-19,Pennsylvania,1,2,0,3,0.3333333333333333
2019-04-19,Texas,1,1,2,4,0.5
2019-04-19,Delaware,0,2,1,3,0.16666666666666666
2019-04-19,Kansas,0,0,2,2,0.5
2019-04-19,Colorado,2,1,4,7,0.5714285714285714
2019-04-19,Alaska,0,1,6,7,0.42857142857142855
2019-04-19,Florida,0,1,2,3,0.3333333333333333
2019-04-19,New York,4,2,0,6,0.6666666666666666
2019-04-19,Virginia,0,1,0,1,0.0
2019-04-19,Louisiana,1,0,2,3,0.6666666666666666
2019-04-19,Arkansas,0,1,5,6,0.4166666666666667
2019-04-19,Oregon,0,2,1,3,0.16666666666666666
2019-04-19,Maryland,0,1,0,1,0.0
2019-04-19,New Hampshire,1,1,0,2,0.5
2019-04-19,Massachusetts,2,2,2,6,0.5
2019-04-19,Arizona,0,0,2,2,0.5
2019-04-19,Nebraska,1,3,0,4,0.25
2019-04-19,Missouri,2,0,1,3,0.8333333333333333
2019-04-19,Maine,0,1,0,1,0.0
2019-04-19,North Carolina,1,0,0,1,1.0
2019-04-19,Idaho,0,1,0,1,0.0
2019-04-19,Rhode Island,0,0,1,1,0.5
2019-04-18,Michigan,1,1,1,3,0.5
2019-04-18,California,6,5,5,16,0.53125
2019-04-18,Hawaii,1,0,3,4,0.625
2019-04-18,Delaware,0,1,2,3,0.3333333333333333
2019-04-18,Alabama,3,2,3,8,0.5625
2019-04-18,Oklahoma,2,0,0,2,1.0
2019-04-18,Washington,0,0,2,2,0.5
2019-04-18,Colorado,0,2,2,4,0.25
2019-04-18,Massachusetts,17,3,4,24,0.7916666666666667
2019-04-18,Arizona,2,0,0,2,1.0
2019-04-18,Arkansas,3,2,9,14,0.5357142857142857
2019-04-18,Maine,2,0,1,3,0.8333333333333333
2019-04-18,Idaho,0,2,0,2,0.0
2019-04-18,Georgia,0,2,1,3,0.16666666666666666
2019-04-18,Oregon,0,0,2,2,0.5
2019-04-18,Illinois,1,0,2,3,0.6666666666666666
2019-04-18,Indiana,3,0,2,5,0.8
2019-04-18,Florida,2,1,2,5,0.6000000000000001
2019-04-18,Kentucky,0,0,1,1,0.5
2019-04-18,Minnesota,1,4,1,6,0.25
2019-04-18,Alaska,2,2,1,5,0.5
2019-04-18,Iowa,2,0,0,2,1.0
2019-04-18,New York,3,0,0,3,1.0
2019-04-18,New Jersey,2,0,0,2,1.0
2019-04-18,Connecticut,0,0,1,1,0.5
2019-04-18,Louisiana,1,1,1,3,0.5
2019-04-18,Texas,1,0,1,2,0.75
2019-04-18,Montana,0,0,1,1,0.5
2019-04-18,Maryland,0,0,1,1,0.5
2019-04-18,Kansas,0,0,1,1,0.5
2019-04-18,Missouri,2,0,0,2,1.0
2019-04-18,Nebraska,0,1,0,1,0.0
2019-04-17,New York,6,0,1,7,0.9285714285714285
2019-04-17,California,10,5,24,39,0.5641025641025641
2019-04-17,Indiana,2,5,3,10,0.35
2019-04-17,Arkansas,6,5,6,17,0.5294117647058824
2019-04-17,Hawaii,2,2,3,7,0.5
2019-04-17,Louisiana,1,0,3,4,0.625
2019-04-17,Delaware,1,0,0,1,1.0
2019-04-17,Michigan,1,1,1,3,0.5
2019-04-17,Texas,2,1,1,4,0.625
2019-04-17,Arizona,3,0,4,7,0.7142857142857142
2019-04-17,Alabama,4,1,4,9,0.6666666666666666
2019-04-17,Missouri,3,0,1,4,0.875
2019-04-17,Massachusetts,14,2,3,19,0.8157894736842105
2019-04-17,North Carolina,0,1,1,2,0.25
2019-04-17,New Mexico,0,0,1,1,0.5
2019-04-17,Iowa,0,2,1,3,0.16666666666666666
2019-04-17,Colorado,0,2,3,5,0.3
2019-04-17,Nebraska,2,1,2,5,0.6000000000000001
2019-04-17,Oregon,0,0,1,1,0.5
2019-04-17,Illinois,0,3,2,5,0.2
2019-04-17,Ohio,0,1,0,1,0.0
2019-04-17,Montana,0,1,0,1,0.0
2019-04-17,Connecticut,1,0,0,1,1.0
2019-04-17,Georgia,0,1,1,2,0.25
2019-04-17,Minnesota,0,1,0,1,0.0
2019-04-17,Florida,1,3,0,4,0.25
2019-04-17,Kansas,0,0,1,1,0.5
2019-04-17,Alaska,1,1,0,2,0.5
2019-04-17,Virginia,0,0,1,1,0.5
2019-04-17,Washington,0,0,1,1,0.5
2019-04-17,Maryland,1,0,1,2,0.75
2019-04-17,New Jersey,0,0,1,1,0.5
2019-04-16,Arizona,0,1,3,4,0.375
2019-04-16,Rhode Island,0,1,0,1,0.0
2019-04-16,Hawaii,4,1,0,5,0.8
2019-04-16,Massachusetts,4,2,3,9,0.611111111111111
2019-04-16,Pennsylvania,1,0,0,1,1.0
2019-04-16,Arkansas,1,4,5,10,0.35
2019-04-16,California,8,4,1,13,0.6538461538461539
2019-04-16,Alabama,1,2,3,6,0.41666666666666663
2019-04-16,Oklahoma,0,0,1,1,0.5
2019-04-16,Indiana,1,2,2,5,0.4
2019-04-16,Georgia,1,1,2,4,0.5
2019-04-16,Texas,0,1,1,2,0.25
2019-04-16,Missouri,1,0,0,1,1.0
2019-04-16,Delaware,0,0,2,2,0.5
2019-04-16,Iowa,1,1,1,3,0.5
2019-04-16,Kansas,1,0,1,2,0.75
2019-04-16,Colorado,3,1,1,5,0.7
2019-04-16,Maryland,0,0,1,1,0.5
2019-04-16,Connecticut,0,0,1,1,0.5
2019-04-16,Oregon,1,1,0,2,0.5
2019-04-16,Virginia,1,0,0,1,1.0
2019-04-16,Louisiana,0,2,1,3,0.16666666666666666
2019-04-16,Nebraska,0,0,1,1,0.5
2019-04-16,Illinois,1,0,0,1,1.0
2019-04-16,Michigan,1,0,2,3,0.6666666666666666
2019-04-16,Florida,2,3,0,5,0.4
2019-04-16,Alaska,1,1,0,2,0.5
2019-04-16,New York,2,0,1,3,0.8333333333333333
2019-04-16,Idaho,0,1,0,1,0.0
2019-04-16,North Carolina,0,0,1,1,0.5
2019-04-15,New York,1,1,6,8,0.5
2019-04-15,Arkansas,5,1,3,9,0.7222222222222222
2019-04-15,Washington,1,0,0,1,1.0
2019-04-15,Alabama,5,2,1,8,0.6875
2019-04-15,Illinois,1,0,4,5,0.6000000000000001
2019-04-15,California,4,3,7,14,0.5357142857142857
2019-04-15,Pennsylvania,0,1,0,1,0.0
2019-04-15,Alaska,2,0,0,2,1.0
2019-04-15,Florida,0,2,2,4,0.25
2019-04-15,Louisiana,0,3,2,5,0.2
2019-04-15,Indiana,3,2,3,8,0.5625
2019-04-15,Hawaii,4,0,2,6,0.8333333333333333
2019-04-15,Texas,3,6,2,11,0.36363636363636365
2019-04-15,Minnesota,1,0,1,2,0.75
2019-04-15,Colorado,1,0,3,4,0.625
2019-04-15,Nebraska,1,1,1,3,0.5
2019-04-15,Kentucky,0,2,0,2,0.0
2019-04-15,Kansas,0,1,0,1,0.0
2019-04-15,Massachusetts,6,2,3,11,0.6818181818181818
2019-04-15,Delaware,5,1,1,7,0.7857142857142857
2019-04-15,Georgia,1,2,1,4,0.375
2019-04-15,Arizona,0,1,0,1,0.0
2019-04-15,Mississippi,0,0,1,1,0.5
2019-04-15,Idaho,1,0,0,1,1.0
2019-04-15,West Virginia,0,1,0,1,0.0
2019-04-15,Iowa,1,1,0,2,0.5
2019-04-15,Missouri,0,1,0,1,0.0
2019-04-15,Michigan,1,0,0,1,1.0
2019-04-15,Oregon,0,0,1,1,0.5
2019-04-15,Maryland,0,0,1,1,0.5
2019-04-15,Wisconsin,0,0,1,1,0.5
2019-04-14,Colorado,0,3,4,7,0.2857142857142857
2019-04-14,Maryland,0,1,0,1,0.0
2019-04-14,Illinois,1,2,8,11,0.4545454545454546
2019-04-14,Hawaii,1,0,3,4,0.625
2019-04-14,Arkansas,0,2,1,3,0.16666666666666666
2019-04-14,Massachusetts,4,2,5,11,0.5909090909090909
2019-04-14,Georgia,2,0,1,3,0.8333333333333333
2019-04-14,Kansas,1,1,1,3,0.5
2019-04-14,California,6,1,8,15,0.6666666666666667
2019-04-14,Connecticut,1,0,1,2,0.75
2019-04-14,Texas,0,1,3,4,0.375
2019-04-14,Florida,1,2,1,4,0.375
2019-04-14,Alaska,0,2,0,2,0.0
2019-04-14,Michigan,1,0,1,2,0.75
2019-04-14,Indiana,2,1,1,4,0.625
2019-04-14,Nebraska,1,0,0,1,1.0
2019-04-14,New York,1,0,1,2,0.75
2019-04-14,New Jersey,1,0,0,1,1.0
2019-04-14,Alabama,0,1,1,2,0.25
2019-04-14,Delaware,0,0,1,1,0.5
2019-04-14,Louisiana,0,1,1,2,0.25
2019-04-14,Arizona,0,0,1,1,0.5
2019-04-14,Washington,0,0,1,1,0.5
2019-04-13,Illinois,1,1,3,5,0.5
2019-04-13,Hawaii,4,1,1,6,0.75
2019-04-13,Indiana,3,3,3,9,0.5
2019-04-13,Delaware,1,0,0,1,1.0
2019-04-13,Massachusetts,4,2,2,8,0.625
2019-04-13,California,4,1,3,8,0.6875
2019-04-13,Arizona,0,3,2,5,0.2
2019-04-13,Kansas,2,0,1,3,0.8333333333333333
2019-04-13,Texas,1,1,2,4,0.5
2019-04-13,New York,4,0,1,5,0.9
2019-04-13,Maine,1,2,0,3,0.3333333333333333
2019-04-13,Arkansas,5,1,1,7,0.7857142857142857
2019-04-13,Alabama,3,0,3,6,0.75
2019-04-13,Colorado,0,2,1,3,0.16666666666666666
2019-04-13,Missouri,0,0,1,1,0.5
2019-04-13,Nevada,0,0,1,1,0.5
2019-04-13,Kentucky,0,1,0,1,0.0
2019-04-13,Florida,1,1,0,2,0.5
2019-04-13,Michigan,2,0,1,3,0.8333333333333333
2019-04-13,Ohio,1,0,0,1,1.0
2019-04-13,Louisiana,1,0,0,1,1.0
2019-04-13,Idaho,0,0,1,1,0.5
2019-04-13,Nebraska,0,2,0,2,0.0
2019-04-12,Massachusetts,11,2,3,16,0.78125
2019-04-12,California,3,4,8,15,0.4666666666666667
2019-04-12,Arkansas,1,4,5,10,0.35
2019-04-12,Hawaii,5,1,3,9,0.7222222222222222
2019-04-12,Kansas,0,0,2,2,0.5
2019-04-12,Missouri,0,1,0,1,0.0
2019-04-12,New York,5,1,1,7,0.7857142857142857
2019-04-12,Indiana,1,2,2,5,0.4
2019-04-12,Nebraska,2,0,0,2,1.0
2019-04-12,Colorado,1,0,3,4,0.625
2019-04-12,Florida,0,2,4,6,0.3333333333333333
2019-04-12,Washington,1,0,0,1,1.0
2019-04-12,Alabama,6,4,1,11,0.5909090909090908
2019-04-12,Louisiana,1,1,4,6,0.5
2019-04-12,Alaska,1,1,0,2,0.5
2019-04-12,Illinois,1,0,0,1,1.0
2019-04-12,New Hampshire,0,1,0,1,0.0
2019-04-12,Delaware,0,0,1,1,0.5
2019-04-12,Kentucky,0,0,1,1,0.5
2019-04-12,Nevada,1,0,1,2,0.75
2019-04-12,Arizona,1,0,3,4,0.625
2019-04-12,Oregon,0,1,1,2,0.25
2019-04-12,Pennsylvania,0,0,1,1,0.5
2019-04-12,New Mexico,0,0,1,1,0.5
2019-04-12,Texas,2,0,0,2,1.0
2019-04-12,Michigan,0,0,1,1,0.5
2019-04-12,Minnesota,0,0,1,1,0.5
2019-04-11,Indiana,4,3,5,12,0.5416666666666666
2019-04-11,Arkansas,3,2,4,9,0.5555555555555556
2019-04-11,New Jersey,1,0,0,1,1.0
2019-04-11,Delaware,0,1,1,2,0.25
2019-04-11,Texas,0,1,4,5,0.4
2019-04-11,Louisiana,2,0,1,3,0.8333333333333333
2019-04-11,Colorado,1,2,4,7,0.42857142857142855
2019-04-11,California,8,9,8,25,0.48
2019-04-11,Massachusetts,5,2,6,13,0.6153846153846154
2019-04-11,Georgia,1,1,2,4,0.5
2019-04-11,Hawaii,1,3,4,8,0.375
2019-04-11,Alabama,4,1,5,10,0.65
2019-04-11,New York,1,1,1,3,0.5
2019-04-11,Kentucky,0,0,2,2,0.5
2019-04-11,Florida,3,2,2,7,0.5714285714285714
2019-04-11,Washington,1,0,1,2,0.75
2019-04-11,Nebraska,1,4,4,9,0.3333333333333333
2019-04-11,Kansas,0,1,1,2,0.25
2019-04-11,New Hampshire,1,0,0,1,1.0
2019-04-11,Iowa,1,0,0,1,1.0
2019-04-11,Missouri,1,0,1,2,0.75
2019-04-11,Connecticut,0,0,1,1,0.5
2019-04-11,Alaska,0,0,1,1,0.5
2019-04-11,Michigan,1,1,0,2,0.5
2019-04-11,Oklahoma,0,0,1,1,0.5
2019-04-11,Oregon,0,1,0,1,0.0
2019-04-11,South Carolina,0,0,1,1,0.5
2019-04-11,Illinois,0,1,0,1,0.0
2019-04-10,New York,2,2,3,7,0.5
2019-04-10,Louisiana,0,3,0,3,0.0
2019-04-10,Delaware,2,0,2,4,0.75
2019-04-10,Arkansas,5,6,7,18,0.4722222222222222
2019-04-10,Oregon,0,0,1,1,0.5
2019-04-10,California,2,9,8,19,0.3157894736842105
2019-04-10,Indiana,2,4,2,8,0.375
2019-04-10,Texas,1,1,8,10,0.5
2019-04-10,Alabama,6,5,4,15,0.5333333333333333
2019-04-10,Massachusetts,3,2,5,10,0.55
2019-04-10,Hawaii,6,8,3,17,0.44117647058823534
2019-04-10,Florida,0,2,1,3,0.16666666666666666
2019-04-10,North Carolina,0,0,1,1,0.5
2019-04-10,Colorado,2,2,5,9,0.5
2019-04-10,Iowa,1,1,0,2,0.5
2019-04-10,Illinois,0,3,4,7,0.2857142857142857
2019-04-10,Mississippi,0,1,0,1,0.0
2019-04-10,Minnesota,0,0,2,2,0.5
2019-04-10,Idaho,0,1,0,1,0.0
2019-04-10,Pennsylvania,0,1,0,1,0.0
2019-04-10,Missouri,1,0,0,1,1.0
2019-04-10,Alaska,1,0,0,1,1.0
2019-04-10,Georgia,3,1,4,8,0.625
2019-04-10,Washington,0,0,1,1,0.5
2019-04-10,Virginia,1,0,0,1,1.0
2019-04-10,Arizona,0,2,0,2,0.0
2019-04-10,Maryland,1,0,1,2,0.75
2019-04-10,Nebraska,0,0,1,1,0.5
2019-04-10,Maine,1,0,0,1,1.0
2019-04-10,Kentucky,0,0,1,1,0.5
2019-04-09,Illinois,1,4,4,9,0.3333333333333333
2019-04-09,Arkansas,2,4,8,14,0.42857142857142855
2019-04-09,Massachusetts,4,4,4,12,0.5
2019-04-09,California,7,6,8,21,0.5238095238095237
2019-04-09,Texas,2,2,1,5,0.5
2019-04-09,Florida,1,2,1,4,0.375
2019-04-09,Delaware,3,1,1,5,0.7
2019-04-09,Hawaii,2,2,3,7,0.5
2019-04-09,Alaska,1,1,2,4,0.5
2019-04-09,Indiana,1,5,7,13,0.34615384615384615
2019-04-09,Arizona,0,1,0,1,0.0
2019-04-09,Nebraska,1,1,5,7,0.5
2019-04-09,Washington,3,0,1,4,0.875
2019-04-09,Ohio,0,1,1,2,0.25
2019-04-09,New York,1,1,2,4,0.5
2019-04-09,New Jersey,0,1,0,1,0.0
2019-04-09,Alabama,1,5,0,6,0.16666666666666666
2019-04-09,Kansas,2,0,0,2,1.0
2019-04-09,Iowa,0,0,1,1,0.5
2019-04-09,Colorado,3,2,1,6,0.5833333333333334
2019-04-09,Connecticut,0,0,1,1,0.5
2019-04-09,Louisiana,3,0,2,5,0.8
2019-04-09,Maryland,2,1,0,3,0.6666666666666666
2019-04-09,Virginia,0,1,0,1,0.0
2019-04-09,Georgia,2,0,3,5,0.7
2019-04-08,Delaware,0,1,4,5,0.4
2019-04-08,California,5,4,7,16,0.53125
2019-04-08,Alabama,1,0,3,4,0.625
2019-04-08,Massachusetts,9,3,4,16,0.6875
2019-04-08,Arizona,1,0,1,2,0.75
2019-04-08,Arkansas,7,1,12,20,0.6499999999999999
2019-04-08,Idaho,0,0,2,2,0.5
2019-04-08,Louisiana,2,1,0,3,0.6666666666666666
2019-04-08,Indiana,0,3,2,5,0.2
2019-04-08,Maryland,1,0,0,1,1.0
2019-04-08,Illinois,1,0,2,3,0.6666666666666666
2019-04-08,Kansas,0,1,1,2,0.25
2019-04-08,Texas,0,1,3,4,0.375
2019-04-08,Washington,1,0,2,3,0.6666666666666666
2019-04-08,Hawaii,3,1,3,7,0.6428571428571428
2019-04-08,Ohio,1,0,0,1,1.0
2019-04-08,New York,1,0,1,2,0.75
2019-04-08,Missouri,0,0,1,1,0.5
2019-04-08,Nebraska,0,0,1,1,0.5
2019-04-08,Florida,1,1,0,2,0.5
2019-04-08,Colorado,0,1,0,1,0.0
2019-04-08,Georgia,1,0,0,1,1.0
2019-04-08,North Dakota,0,0,1,1,0.5
2019-04-07,Florida,3,1,4,8,0.625
2019-04-07,Kansas,0,0,1,1,0.5
2019-04-07,Arkansas,4,3,5,12,0.5416666666666666
2019-04-07,Colorado,0,4,0,4,0.0
2019-04-07,Idaho,0,1,0,1,0.0
2019-04-07,Alabama,1,1,0,2,0.5
2019-04-07,California,5,1,2,8,0.75
2019-04-07,Arizona,0,0,2,2,0.5
2019-04-07,Washington,1,0,0,1,1.0
2019-04-07,North Carolina,0,0,2,2,0.5
2019-04-07,Massachusetts,0,1,1,2,0.25
2019-04-07,Virginia,0,0,1,1,0.5
2019-04-07,Delaware,0,0,1,1,0.5
2019-04-07,Oregon,2,1,1,4,0.625
2019-04-07,Indiana,1,0,2,3,0.6666666666666666
2019-04-07,Louisiana,3,1,1,5,0.7
2019-04-07,Alaska,0,1,0,1,0.0
2019-04-07,Georgia,0,0,3,3,0.5
2019-04-07,Iowa,1,0,0,1,1.0
2019-04-07,Texas,0,0,1,1,0.5
2019-04-07,New York,1,0,0,1,1.0
2019-04-07,Hawaii,0,1,0,1,0.0
2019-04-07,Missouri,0,0,1,1,0.5
2019-04-07,New Mexico,0,0,1,1,0.5
2019-04-07,Nebraska,0,0,1,1,0.5
2019-04-06,New York,3,1,4,8,0.625
2019-04-06,Alabama,1,5,2,8,0.25
2019-04-06,Arkansas,7,5,1,13,0.5769230769230769
2019-04-06,California,3,2,4,9,0.5555555555555556
2019-04-06,Illinois,0,1,1,2,0.25
2019-04-06,Florida,2,3,2,7,0.42857142857142855
2019-04-06,Hawaii,0,2,2,4,0.25
2019-04-06,Missouri,0,1,1,2,0.25
2019-04-06,Massachusetts,3,1,1,5,0.7
2019-04-06,Georgia,1,3,1,5,0.30000000000000004
2019-04-06,Louisiana,4,1,3,8,0.6875
2019-04-06,Arizona,0,1,2,3,0.3333333333333333
2019-04-06,Indiana,2,0,3,5,0.7
2019-04-06,Texas,1,1,2,4,0.5
2019-04-06,Iowa,0,0,2,2,0.5
2019-04-06,Alaska,1,0,2,3,0.6666666666666666
2019-04-06,Nebraska,0,1,2,3,0.3333333333333333
2019-04-06,Kansas,0,2,2,4,0.25
2019-04-06,Mississippi,0,0,1,1,0.5
2019-04-06,Delaware,0,0,1,1,0.5
2019-04-06,Washington,0,0,1,1,0.5
2019-04-06,Minnesota,0,1,0,1,0.0
2019-04-06,North Carolina,1,0,0,1,1.0
2019-04-06,Colorado,1,0,1,2,0.75
2019-04-05,Nebraska,0,1,2,3,0.3333333333333333
2019-04-05,California,5,7,11,23,0.4565217391304348
2019-04-05,Hawaii,6,1,3,10,0.75
2019-04-05,Arkansas,6,5,3,14,0.5357142857142857
2019-04-05,Alabama,1,3,3,7,0.3571428571428571
2019-04-05,Arizona,2,1,0,3,0.6666666666666666
2019-04-05,Illinois,1,1,2,4,0.5
2019-04-05,Texas,0,0,3,3,0.5
2019-04-05,North Carolina,0,0,1,1,0.5
2019-04-05,Indiana,1,3,3,7,0.3571428571428571
2019-04-05,Maryland,0,1,0,1,0.0
2019-04-05,Connecticut,0,0,1,1,0.5
2019-04-05,Colorado,2,0,0,2,1.0
2019-04-05,Maine,0,1,0,1,0.0
2019-04-05,Florida,0,3,1,4,0.125
2019-04-05,New York,2,0,0,2,1.0
2019-04-05,New Jersey,1,0,0,1,1.0
2019-04-05,Montana,1,0,0,1,1.0
2019-04-05,Michigan,1,1,0,2,0.5
2019-04-05,Oregon,1,0,2,3,0.6666666666666666
2019-04-05,Massachusetts,4,3,1,8,0.5625
2019-04-05,Alaska,2,1,0,3,0.6666666666666666
2019-04-05,Delaware,1,0,1,2,0.75
2019-04-05,Georgia,2,0,3,5,0.7
2019-04-05,Kentucky,0,0,1,1,0.5
2019-04-05,Missouri,0,1,0,1,0.0
2019-04-04,California,7,5,5,17,0.5588235294117647
2019-04-04,Louisiana,1,2,0,3,0.3333333333333333
2019-04-04,Hawaii,5,6,3,14,0.4642857142857143
2019-04-04,New York,2,0,3,5,0.7
2019-04-04,Arkansas,3,2,4,9,0.5555555555555556
2019-04-04,Connecticut,0,0,2,2,0.5
2019-04-04,Indiana,1,1,6,8,0.5
2019-04-04,Arizona,1,2,0,3,0.3333333333333333
2019-04-04,Alaska,1,1,0,2,0.5
2019-04-04,Nebraska,0,1,4,5,0.4
2019-04-04,Iowa,0,0,3,3,0.5
2019-04-04,Alabama,0,4,7,11,0.3181818181818182
2019-04-04,Kentucky,0,2,0,2,0.0
2019-04-04,Pennsylvania,0,0,1,1,0.5
2019-04-04,Colorado,0,3,2,5,0.2
2019-04-04,Maine,1,0,0,1,1.0
2019-04-04,Massachusetts,5,2,1,8,0.6875
2019-04-04,Michigan,0,0,1,1,0.5
2019-04-04,Delaware,1,2,0,3,0.3333333333333333
2019-04-04,Texas,1,0,0,1,1.0
2019-04-04,Maryland,1,0,0,1,1.0
2019-04-04,Florida,2,0,0,2,1.0
2019-04-03,Indiana,1,1,3,5,0.5
2019-04-03,Washington,0,1,0,1,0.0
2019-04-03,Arkansas,4,3,3,10,0.55
2019-04-03,California,9,4,5,18,0.6388888888888888
2019-04-03,Georgia,1,1,0,2,0.5
2019-04-03,Michigan,2,0,0,2,1.0
2019-04-03,Colorado,3,1,1,5,0.7
2019-04-03,Massachusetts,3,2,2,7,0.5714285714285714
2019-04-03,Florida,1,1,2,4,0.5
2019-04-03,Alabama,2,4,4,10,0.4
2019-04-03,Illinois,0,0,3,3,0.5
2019-04-03,Delaware,1,0,0,1,1.0
2019-04-03,Arizona,0,0,1,1,0.5
2019-04-03,Texas,0,2,1,3,0.16666666666666666
2019-04-03,North Carolina,1,0,0,1,1.0
2019-04-03,Hawaii,1,1,3,5,0.5
2019-04-03,Alaska,3,0,0,3,1.0
2019-04-03,Nebraska,1,1,1,3,0.5
2019-04-03,Louisiana,0,0,1,1,0.5
2019-04-03,Oregon,1,0,0,1,1.0
2019-04-03,Oklahoma,0,1,0,1,0.0
2019-04-03,Virginia,0,1,0,1,0.0
2019-04-03,Pennsylvania,1,0,0,1,1.0
2019-04-03,New Hampshire,0,0,1,1,0.5
2019-04-03,Iowa,1,0,0,1,1.0
2019-04-03,New York,2,0,1,3,0.8333333333333333
2019-04-03,Kansas,0,1,0,1,0.0
2019-04-02,Arkansas,5,7,8,20,0.45
2019-04-02,California,10,11,6,27,0.48148148148148145
2019-04-02,Georgia,0,0,2,2,0.5
2019-04-02,Colorado,0,2,3,5,0.3
2019-04-02,Washington,0,1,1,2,0.25
2019-04-02,Delaware,0,2,2,4,0.25
2019-04-02,Missouri,0,0,1,1,0.5
2019-04-02,Massachusetts,1,1,3,5,0.5
2019-04-02,Louisiana,0,0,1,1,0.5
2019-04-02,Texas,1,1,3,5,0.5
2019-04-02,Hawaii,1,1,3,5,0.5
2019-04-02,Indiana,1,0,4,5,0.6000000000000001
2019-04-02,New York,2,0,3,5,0.7
2019-04-02,Florida,2,3,1,6,0.41666666666666663
2019-04-02,Arizona,3,0,4,7,0.7142857142857142
2019-04-02,New Hampshire,1,0,0,1,1.0
2019-04-02,Alaska,1,1,2,4,0.5
2019-04-02,Alabama,2,1,5,8,0.5625
2019-04-02,Illinois,3,2,3,8,0.5625
2019-04-02,Kentucky,0,0,1,1,0.5
2019-04-02,Mississippi,0,0,1,1,0.5
2019-04-02,Pennsylvania,2,2,0,4,0.5
2019-04-02,Nebraska,0,1,0,1,0.0
2019-04-02,Idaho,0,0,1,1,0.5
2019-04-02,Kansas,1,0,0,1,1.0
2019-04-02,North Carolina,0,1,3,4,0.375
2019-04-02,Maryland,1,0,0,1,1.0
2019-04-02,South Carolina,0,0,1,1,0.5
2019-04-01,Alabama,3,4,7,14,0.4642857142857143
2019-04-01,Arkansas,4,2,4,10,0.6000000000000001
2019-04-01,New York,2,1,1,4,0.625
2019-04-01,Alaska,1,0,1,2,0.75
2019-04-01,Hawaii,1,3,6,10,0.4
2019-04-01,Illinois,1,0,1,2,0.75
2019-04-01,Kentucky,0,1,0,1,0.0
2019-04-01,California,4,4,9,17,0.5
2019-04-01,Colorado,3,1,1,5,0.7
2019-04-01,Texas,0,2,0,2,0.0
2019-04-01,Washington,0,4,2,6,0.16666666666666666
2019-04-01,Georgia,1,0,3,4,0.625
2019-04-01,Florida,0,2,2,4,0.25
2019-04-01,Louisiana,1,1,2,4,0.5
2019-04-01,Oklahoma,0,0,1,1,0.5
2019-04-01,Massachusetts,4,1,2,7,0.7142857142857142
2019-04-01,Delaware,1,0,1,2,0.75
2019-04-01,New Jersey,0,0,2,2,0.5
2019-04-01,Indiana,2,4,5,11,0.40909090909090906
2019-04-01,Idaho,1,0,1,2,0.75
2019-04-01,Nebraska,2,0,1,3,0.8333333333333333
2019-04-01,Virginia,0,0,1,1,0.5
2019-04-01,Arizona,2,0,0,2,1.0
2019-04-01,Missouri,3,0,2,5,0.8
2019-04-01,Ohio,1,0,0,1,1.0
2019-04-01,Minnesota,1,0,0,1,1.0
2019-04-01,Kansas,1,1,0,2,0.5
2019-04-01,Iowa,0,1,0,1,0.0
2019-04-01,New Mexico,1,0,0,1,1.0
2019-03-31,Hawaii,2,1,1,4,0.625
2019-03-31,Louisiana,2,1,3,6,0.5833333333333333
2019-03-31,Rhode Island,0,1,0,1,0.0
2019-03-31,California,4,2,10,16,0.5625
2019-03-31,Oklahoma,0,0,1,1,0.5
2019-03-31,Georgia,1,2,0,3,0.3333333333333333
2019-03-31,Iowa,2,1,2,5,0.6000000000000001
2019-03-31,Kansas,1,0,0,1,1.0
2019-03-31,Indiana,0,1,4,5,0.4
2019-03-31,Florida,0,1,2,3,0.3333333333333333
2019-03-31,Connecticut,5,0,1,6,0.9166666666666667
2019-03-31,Massachusetts,3,3,4,10,0.5
2019-03-31,Colorado,1,3,6,10,0.4
2019-03-31,Michigan,1,0,0,1,1.0
2019-03-31,Arkansas,7,8,4,19,0.47368421052631576
2019-03-31,Alabama,2,2,3,7,0.5
2019-03-31,Idaho,1,0,0,1,1.0
2019-03-31,Texas,1,0,0,1,1.0
2019-03-31,Ohio,0,0,1,1,0.5
2019-03-31,Missouri,0,0,1,1,0.5
2019-03-31,Alaska,3,0,0,3,1.0
2019-03-31,Nebraska,0,0,2,2,0.5
2019-03-31,Washington,2,0,0,2,1.0
2019-03-31,Pennsylvania,0,0,1,1,0.5
2019-03-31,Illinois,1,1,0,2,0.5
2019-03-31,New York,1,2,2,5,0.4
2019-03-31,Delaware,0,0,1,1,0.5
2019-03-31,Arizona,0,1,2,3,0.3333333333333333
2019-03-30,Florida,4,5,3,12,0.4583333333333333
2019-03-30,Arkansas,7,6,7,20,0.5249999999999999
2019-03-30,Hawaii,6,2,2,10,0.7
2019-03-30,Ohio,0,1,0,1,0.0
2019-03-30,Washington,0,0,2,2,0.5
2019-03-30,Nebraska,1,1,1,3,0.5
2019-03-30,California,7,7,12,26,0.5
2019-03-30,Indiana,0,5,4,9,0.2222222222222222
2019-03-30,Texas,1,1,3,5,0.5
2019-03-30,Alabama,1,2,5,8,0.4375
2019-03-30,Georgia,2,1,2,5,0.6000000000000001
2019-03-30,Massachusetts,5,2,2,9,0.6666666666666667
2019-03-30,Utah,0,1,0,1,0.0
2019-03-30,Kansas,1,0,1,2,0.75
2019-03-30,Colorado,2,2,0,4,0.5
2019-03-30,New York,2,0,1,3,0.8333333333333333
2019-03-30,Illinois,2,1,2,5,0.6000000000000001
2019-03-30,Michigan,0,1,0,1,0.0
2019-03-30,Idaho,0,1,0,1,0.0
2019-03-30,Missouri,1,0,2,3,0.6666666666666666
2019-03-30,Minnesota,1,0,1,2,0.75
2019-03-30,Oregon,1,0,0,1,1.0
2019-03-30,Iowa,0,2,0,2,0.0
2019-03-30,Louisiana,0,1,0,1,0.0
2019-03-30,North Carolina,0,1,0,1,0.0
2019-03-30,Alaska,0,1,2,3,0.3333333333333333
2019-03-30,Arizona,0,1,0,1,0.0
2019-03-30,Connecticut,1,0,0,1,1.0
2019-03-29,California,9,8,13,30,0.5166666666666666
2019-03-29,New Mexico,1,0,0,1,1.0
2019-03-29,Massachusetts,6,2,6,14,0.6428571428571428
2019-03-29,Illinois,2,0,1,3,0.8333333333333333
2019-03-29,Florida,1,4,3,8,0.3125
2019-03-29,Georgia,2,0,4,6,0.6666666666666666
2019-03-29,Nebraska,4,3,2,9,0.5555555555555556
2019-03-29,Arkansas,3,2,10,15,0.5333333333333333
2019-03-29,New York,10,5,9,24,0.6041666666666667
2019-03-29,Indiana,2,0,4,6,0.6666666666666666
2019-03-29,Arizona,2,2,1,5,0.5
2019-03-29,Missouri,0,4,1,5,0.1
2019-03-29,Alaska,1,0,1,2,0.75
2019-03-29,Colorado,1,1,1,3,0.5
2019-03-29,Alabama,2,1,1,4,0.625
2019-03-29,Hawaii,4,2,1,7,0.6428571428571428
2019-03-29,Connecticut,0,2,1,3,0.16666666666666666
2019-03-29,Michigan,2,1,2,5,0.6000000000000001
2019-03-29,Idaho,0,2,0,2,0.0
2019-03-29,Louisiana,0,2,2,4,0.25
2019-03-29,Maine,0,0,1,1,0.5
2019-03-29,North Carolina,0,0,1,1,0.5
2019-03-29,Kansas,1,2,1,4,0.375
2019-03-29,Delaware,0,1,2,3,0.3333333333333333
2019-03-29,Maryland,0,1,0,1,0.0
2019-03-29,Texas,0,0,3,3,0.5
2019-03-29,North Dakota,0,0,1,1,0.5
2019-03-29,Oregon,0,0,1,1,0.5
2019-03-29,Washington,0,0,1,1,0.5
2019-03-29,Virginia,0,1,0,1,0.0
2019-03-28,Indiana,2,4,2,8,0.375
2019-03-28,Louisiana,0,2,4,6,0.3333333333333333
2019-03-28,Georgia,5,1,3,9,0.7222222222222222
2019-03-28,California,12,13,14,39,0.4871794871794872
2019-03-28,Hawaii,3,1,7,11,0.5909090909090908
2019-03-28,Mississippi,1,0,0,1,1.0
2019-03-28,Arkansas,5,2,6,13,0.6153846153846154
2019-03-28,Massachusetts,1,3,10,14,0.4285714285714286
2019-03-28,Oregon,2,3,1,6,0.41666666666666663
2019-03-28,Florida,1,7,5,13,0.2692307692307693
2019-03-28,Alabama,5,6,4,15,0.4666666666666667
2019-03-28,Illinois,3,4,4,11,0.45454545454545453
2019-03-28,New Jersey,0,0,1,1,0.5
2019-03-28,Minnesota,0,1,0,1,0.0
2019-03-28,Arizona,0,1,2,3,0.3333333333333333
2019-03-28,Colorado,0,0,6,6,0.5
2019-03-28,Texas,2,2,3,7,0.5
2019-03-28,Ohio,1,0,1,2,0.75
2019-03-28,Nebraska,2,1,1,4,0.625
2019-03-28,Alaska,0,1,4,5,0.4
2019-03-28,New York,3,2,0,5,0.6
2019-03-28,Nevada,0,0,1,1,0.5
2019-03-28,Tennessee,0,0,1,1,0.5
2019-03-28,Maryland,1,0,1,2,0.75
2019-03-28,Delaware,2,0,2,4,0.75
2019-03-28,Michigan,0,0,1,1,0.5
2019-03-28,Connecticut,0,1,0,1,0.0
2019-03-28,Washington,1,1,0,2,0.5
2019-03-28,Kentucky,0,0,1,1,0.5
2019-03-28,Pennsylvania,1,1,0,2,0.5
2019-03-28,North Carolina,0,0,1,1,0.5
2019-03-27,Arkansas,8,8,13,29,0.5
2019-03-27,Texas,6,6,6,18,0.5
2019-03-27,California,21,14,16,51,0.5686274509803921
2019-03-27,Arizona,3,8,11,22,0.38636363636363635
2019-03-27,Louisiana,4,6,5,15,0.43333333333333335
2019-03-27,Indiana,4,3,5,12,0.5416666666666666
2019-03-27,New Mexico,0,0,1,1,0.5
2019-03-27,Alabama,11,12,10,33,0.48484848484848486
2019-03-27,Hawaii,1,5,11,17,0.3823529411764706
2019-03-27,Oklahoma,0,1,1,2,0.25
2019-03-27,Colorado,4,3,5,12,0.5416666666666666
2019-03-27,Nebraska,5,0,2,7,0.8571428571428572
2019-03-27,Massachusetts,5,5,4,14,0.5
2019-03-27,Pennsylvania,0,0,1,1,0.5
2019-03-27,New York,4,2,3,9,0.611111111111111
2019-03-27,Michigan,3,1,1,5,0.7
2019-03-27,Oregon,2,1,3,6,0.5833333333333333
2019-03-27,Florida,4,5,3,12,0.4583333333333333
2019-03-27,Illinois,2,5,5,12,0.375
2019-03-27,Connecticut,0,1,2,3,0.3333333333333333
2019-03-27,Georgia,5,1,5,11,0.6818181818181818
2019-03-27,Iowa,0,0,4,4,0.5
2019-03-27,New Jersey,2,0,2,4,0.75
2019-03-27,Missouri,2,0,1,3,0.8333333333333333
2019-03-27,Minnesota,3,1,1,5,0.7
2019-03-27,Kansas,6,0,2,8,0.875
2019-03-27,Kentucky,0,1,1,2,0.25
2019-03-27,Alaska,4,3,1,8,0.5625
2019-03-27,Maryland,1,1,0,2,0.5
2019-03-27,Delaware,2,1,1,4,0.625
2019-03-27,North Carolina,0,1,0,1,0.0
2019-03-27,Wisconsin,0,0,1,1,0.5
2019-03-26,California,18,14,16,48,0.5416666666666666
2019-03-26,Massachusetts,13,2,8,23,0.7391304347826086
2019-03-26,Arkansas,6,7,11,24,0.47916666666666663
2019-03-26,Hawaii,10,9,12,31,0.5161290322580645
2019-03-26,Florida,1,4,1,6,0.25
2019-03-26,Alabama,5,6,6,17,0.47058823529411764
2019-03-26,Texas,2,3,6,11,0.45454545454545453
2019-03-26,Wisconsin,0,1,0,1,0.0
2019-03-26,Louisiana,1,4,5,10,0.35
2019-03-26,Delaware,2,2,3,7,0.5
2019-03-26,Arizona,4,5,2,11,0.4545454545454546
2019-03-26,Georgia,2,2,1,5,0.5
2019-03-26,Oklahoma,1,0,0,1,1.0
2019-03-26,New York,5,1,5,11,0.6818181818181818
2019-03-26,Illinois,7,2,9,18,0.6388888888888888
2019-03-26,Iowa,2,1,3,6,0.5833333333333333
2019-03-26,Kansas,5,0,3,8,0.8125
2019-03-26,Indiana,3,12,12,27,0.3333333333333333
2019-03-26,Colorado,3,2,1,6,0.5833333333333334
2019-03-26,Mississippi,0,0,1,1,0.5
2019-03-26,North Carolina,2,2,0,4,0.5
2019-03-26,Maine,1,0,0,1,1.0
2019-03-26,Ohio,0,0,1,1,0.5
2019-03-26,Oregon,1,2,0,3,0.3333333333333333
2019-03-26,Pennsylvania,1,2,1,4,0.375
2019-03-26,Nebraska,2,2,3,7,0.5
2019-03-26,Alaska,2,3,7,12,0.45833333333333337
2019-03-26,North Dakota,1,0,0,1,1.0
2019-03-26,Kentucky,0,3,0,3,0.0
2019-03-26,Washington,0,1,3,4,0.375
2019-03-26,Maryland,1,1,0,2,0.5
2019-03-26,Missouri,2,0,1,3,0.8333333333333333
2019-03-25,New York,0,1,2,3,0.3333333333333333
2019-03-25,Arizona,0,0,2,2,0.5
2019-03-25,Illinois,1,0,2,3,0.6666666666666666
2019-03-25,Nebraska,0,1,0,1,0.0
2019-03-25,Indiana,5,0,2,7,0.8571428571428572
2019-03-25,Louisiana,1,0,0,1,1.0
2019-03-25,California,5,2,4,11,0.6363636363636364
2019-03-25,Alaska,2,3,0,5,0.4
2019-03-25,New Jersey,0,1,0,1,0.0
2019-03-25,Massachusetts,0,0,5,5,0.5
2019-03-25,Pennsylvania,0,1,0,1,0.0
2019-03-25,Alabama,2,0,3,5,0.7
2019-03-25,Idaho,0,0,3,3,0.5
2019-03-25,Maryland,2,0,0,2,1.0
2019-03-25,Arkansas,2,1,1,4,0.625
2019-03-25,Michigan,0,0,1,1,0.5
2019-03-25,Colorado,0,1,0,1,0.0
2019-03-25,Hawaii,2,1,1,4,0.625
2019-03-25,Texas,0,1,0,1,0.0
2019-03-25,Washington,0,1,0,1,0.0
2019-03-25,Oklahoma,0,1,0,1,0.0
2019-03-25,Minnesota,0,0,1,1,0.5
2019-03-25,Iowa,0,3,0,3,0.0
2019-03-25,Delaware,0,0,2,2,0.5
2019-03-25,Oregon,1,0,0,1,1.0
2019-03-25,Georgia,0,1,0,1,0.0
2019-03-24,Alabama,1,5,3,9,0.2777777777777778
2019-03-24,Kansas,0,1,0,1,0.0
2019-03-24,Massachusetts,5,3,1,9,0.6111111111111112
2019-03-24,Delaware,1,5,3,9,0.2777777777777778
2019-03-24,California,3,3,5,11,0.5
2019-03-24,Florida,1,1,3,5,0.5
2019-03-24,Alaska,2,1,2,5,0.6000000000000001
2019-03-24,Texas,0,0,1,1,0.5
2019-03-24,New York,1,1,0,2,0.5
2019-03-24,Indiana,2,0,1,3,0.8333333333333333
2019-03-24,Hawaii,2,0,0,2,1.0
2019-03-24,Arkansas,1,3,2,6,0.3333333333333333
2019-03-24,Oklahoma,0,1,0,1,0.0
2019-03-24,Louisiana,1,0,1,2,0.75
2019-03-24,Oregon,0,0,1,1,0.5
2019-03-24,Maryland,1,0,0,1,1.0
2019-03-24,Nebraska,0,0,1,1,0.5
2019-03-24,Utah,0,1,0,1,0.0
2019-03-24,North Dakota,0,0,1,1,0.5
2019-03-24,Georgia,0,1,2,3,0.3333333333333333
2019-03-24,Arizona,2,0,0,2,1.0
2019-03-24,Illinois,1,0,0,1,1.0
2019-03-24,Idaho,1,0,0,1,1.0
2019-03-23,California,13,7,5,25,0.62
2019-03-23,Alabama,2,3,3,8,0.4375
2019-03-23,Massachusetts,2,3,0,5,0.4
2019-03-23,Texas,0,0,3,3,0.5
2019-03-23,Florida,0,3,0,3,0.0
2019-03-23,Nebraska,0,1,0,1,0.0
2019-03-23,Indiana,5,1,4,10,0.7
2019-03-23,Arkansas,4,6,3,13,0.42307692307692313
2019-03-23,Colorado,2,0,3,5,0.7
2019-03-23,Kansas,1,0,0,1,1.0
2019-03-23,Illinois,3,0,2,5,0.8
2019-03-23,Alaska,1,1,1,3,0.5
2019-03-23,Georgia,2,2,0,4,0.5
2019-03-23,Hawaii,3,2,0,5,0.6
2019-03-23,Louisiana,1,0,1,2,0.75
2019-03-23,Oklahoma,1,0,0,1,1.0
2019-03-23,Iowa,1,0,1,2,0.75
2019-03-23,Michigan,1,1,0,2,0.5
2019-03-23,New York,1,1,0,2,0.5
2019-03-23,Delaware,0,1,0,1,0.0
2019-03-23,Virginia,0,0,1,1,0.5
2019-03-23,Arizona,0,1,0,1,0.0
2019-03-22,Illinois,3,1,1,5,0.7
2019-03-22,California,4,5,7,16,0.46875
2019-03-22,Georgia,0,1,2,3,0.3333333333333333
2019-03-22,Massachusetts,5,2,3,10,0.65
2019-03-22,Hawaii,2,3,3,8,0.4375
2019-03-22,Texas,0,2,1,3,0.16666666666666666
2019-03-22,Iowa,0,2,3,5,0.3
2019-03-22,Kentucky,0,1,0,1,0.0
2019-03-22,Indiana,1,0,3,4,0.625
2019-03-22,Arkansas,3,3,7,13,0.5
2019-03-22,Alabama,6,3,7,16,0.59375
2019-03-22,Delaware,2,0,3,5,0.7
2019-03-22,Nebraska,0,1,2,3,0.3333333333333333
2019-03-22,Oregon,1,0,1,2,0.75
2019-03-22,New York,3,0,2,5,0.8
2019-03-22,Colorado,4,0,2,6,0.8333333333333333
2019-03-22,Maine,0,1,0,1,0.0
2019-03-22,Florida,0,3,2,5,0.2
2019-03-22,Utah,0,0,2,2,0.5
2019-03-22,Maryland,2,1,0,3,0.6666666666666666
2019-03-22,Michigan,1,0,0,1,1.0
2019-03-22,Alaska,2,0,1,3,0.8333333333333333
2019-03-22,Connecticut,1,0,0,1,1.0
2019-03-22,Pennsylvania,0,0,1,1,0.5
2019-03-22,Louisiana,1,0,0,1,1.0
2019-03-21,New York,1,0,1,2,0.75
2019-03-21,Delaware,0,0,3,3,0.5
2019-03-21,California,8,3,8,19,0.631578947368421
2019-03-21,Washington,1,0,1,2,0.75
2019-03-21,Arkansas,1,0,3,4,0.625
2019-03-21,Pennsylvania,0,1,0,1,0.0
2019-03-21,Hawaii,2,1,1,4,0.625
2019-03-21,Florida,1,0,2,3,0.6666666666666666
2019-03-21,Iowa,1,0,0,1,1.0
2019-03-21,Indiana,0,0,1,1,0.5
2019-03-21,Colorado,1,1,2,4,0.5
2019-03-21,Kansas,1,0,1,2,0.75
2019-03-21,Massachusetts,3,1,1,5,0.7
2019-03-21,Alabama,4,2,0,6,0.6666666666666666
2019-03-21,Michigan,2,0,0,2,1.0
2019-03-21,Texas,0,2,0,2,0.0
2019-03-21,Georgia,1,1,2,4,0.5
2019-03-21,Alaska,2,1,0,3,0.6666666666666666
2019-03-21,Arizona,0,1,2,3,0.3333333333333333
2019-03-21,New Jersey,0,1,2,3,0.3333333333333333
2019-03-21,Nebraska,0,0,1,1,0.5
2019-03-21,Louisiana,0,0,2,2,0.5
2019-03-21,Illinois,1,1,3,5,0.5
2019-03-21,North Carolina,2,0,0,2,1.0
2019-03-21,Oregon,0,0,1,1,0.5
2019-03-21,Oklahoma,0,0,1,1,0.5
2019-03-20,Missouri,1,0,1,2,0.75
2019-03-20,Oklahoma,0,0,1,1,0.5
2019-03-20,Alabama,2,1,6,9,0.5555555555555556
2019-03-20,Michigan,0,1,2,3,0.3333333333333333
2019-03-20,Texas,0,1,1,2,0.25
2019-03-20,Alaska,1,1,0,2,0.5
2019-03-20,California,4,4,5,13,0.5
2019-03-20,Iowa,1,1,0,2,0.5
2019-03-20,Massachusetts,4,2,4,10,0.6000000000000001
2019-03-20,Arkansas,2,3,4,9,0.4444444444444444
2019-03-20,Louisiana,2,1,1,4,0.625
2019-03-20,Indiana,0,3,2,5,0.2
2019-03-20,Illinois,0,1,0,1,0.0
2019-03-20,Washington,0,0,2,2,0.5
2019-03-20,Georgia,2,0,0,2,1.0
2019-03-20,Hawaii,0,0,3,3,0.5
2019-03-20,New York,1,0,0,1,1.0
2019-03-20,Florida,0,2,1,3,0.16666666666666666
2019-03-20,Colorado,0,0,1,1,0.5
2019-03-20,Arizona,0,0,1,1,0.5
2019-03-20,Pennsylvania,1,0,0,1,1.0
2019-03-20,Maine,0,1,0,1,0.0
2019-03-20,Nebraska,0,1,0,1,0.0
2019-03-20,Utah,0,1,0,1,0.0
2019-03-19,Arkansas,2,1,5,8,0.5625
2019-03-19,Colorado,0,2,0,2,0.0
2019-03-19,Alabama,3,2,5,10,0.55
2019-03-19,California,1,4,2,7,0.2857142857142857
2019-03-19,Washington,1,1,2,4,0.5
2019-03-19,Nebraska,0,1,2,3,0.3333333333333333
2019-03-19,Idaho,1,0,0,1,1.0
2019-03-19,Nevada,0,0,1,1,0.5
2019-03-19,Hawaii,2,1,1,4,0.625
2019-03-19,Florida,1,0,3,4,0.625
2019-03-19,Maryland,1,0,0,1,1.0
2019-03-19,Illinois,3,2,2,7,0.5714285714285714
2019-03-19,Indiana,1,1,2,4,0.5
2019-03-19,Iowa,0,1,0,1,0.0
2019-03-19,Massachusetts,1,3,1,5,0.30000000000000004
2019-03-19,North Dakota,0,0,1,1,0.5
2019-03-19,Connecticut,0,0,1,1,0.5
2019-03-19,Arizona,1,1,2,4,0.5
2019-03-19,Michigan,0,0,1,1,0.5
2019-03-19,New York,1,1,1,3,0.5
2019-03-19,South Carolina,0,1,0,1,0.0
2019-03-19,Oregon,0,0,1,1,0.5
2019-03-19,Texas,0,0,3,3,0.5
2019-03-19,Georgia,0,0,1,1,0.5
2019-03-18,Colorado,0,1,1,2,0.25
2019-03-18,Alaska,0,0,1,1,0.5
2019-03-18,Hawaii,2,1,1,4,0.625
2019-03-18,Arkansas,4,4,6,14,0.5
2019-03-18,Texas,0,2,0,2,0.0
2019-03-18,Idaho,1,0,0,1,1.0
2019-03-18,California,2,4,1,7,0.3571428571428571
2019-03-18,New York,3,2,1,6,0.5833333333333334
2019-03-18,North Carolina,0,0,1,1,0.5
2019-03-18,Alabama,1,1,5,7,0.5
2019-03-18,Michigan,0,1,1,2,0.25
2019-03-18,Washington,2,0,0,2,1.0
2019-03-18,Georgia,1,1,0,2,0.5
2019-03-18,Florida,1,2,0,3,0.3333333333333333
2019-03-18,Iowa,0,2,1,3,0.16666666666666666
2019-03-18,Indiana,2,0,2,4,0.75
2019-03-18,Louisiana,1,0,1,2,0.75
2019-03-18,Connecticut,0,1,1,2,0.25
2019-03-18,Illinois,1,0,1,2,0.75
2019-03-18,Nebraska,1,0,1,2,0.75
2019-03-18,Delaware,1,1,0,2,0.5
2019-03-18,Massachusetts,1,0,2,3,0.6666666666666666
2019-03-18,Arizona,0,0,1,1,0.5
2019-03-18,Virginia,0,0,1,1,0.5
2019-03-18,Oregon,0,1,1,2,0.25
2019-03-17,Arkansas,0,3,3,6,0.25
2019-03-17,Nebraska,1,1,1,3,0.5
2019-03-17,California,0,7,3,10,0.15
2019-03-17,Michigan,0,2,0,2,0.0
2019-03-17,Hawaii,0,0,2,2,0.5
2019-03-17,Kentucky,0,1,1,2,0.25
2019-03-17,Alabama,1,1,4,6,0.5
2019-03-17,Oregon,0,0,1,1,0.5
2019-03-17,Arizona,0,2,0,2,0.0
2019-03-17,Illinois,0,1,0,1,0.0
2019-03-17,Indiana,0,4,4,8,0.25
2019-03-17,Georgia,0,2,3,5,0.3
2019-03-17,Louisiana,1,0,3,4,0.625
2019-03-17,Massachusetts,1,1,0,2,0.5
2019-03-17,Alaska,0,2,0,2,0.0
2019-03-17,Kansas,0,1,0,1,0.0
2019-03-17,New York,0,1,1,2,0.25
2019-03-17,Florida,2,2,0,4,0.5
2019-03-17,Delaware,2,1,0,3,0.6666666666666666
2019-03-17,Texas,0,4,1,5,0.1
2019-03-17,Iowa,0,2,1,3,0.16666666666666666
2019-03-17,Ohio,0,1,0,1,0.0
2019-03-17,Colorado,1,0,2,3,0.6666666666666666
2019-03-17,Washington,0,1,0,1,0.0
2019-03-16,Alabama,1,5,6,12,0.3333333333333333
2019-03-16,Maine,1,0,1,2,0.75
2019-03-16,Colorado,0,1,2,3,0.3333333333333333
2019-03-16,Iowa,0,0,3,3,0.5
2019-03-16,Indiana,1,2,0,3,0.3333333333333333
2019-03-16,California,2,3,6,11,0.45454545454545453
2019-03-16,Georgia,2,2,3,7,0.5
2019-03-16,Hawaii,2,1,2,5,0.6000000000000001
2019-03-16,Texas,0,2,0,2,0.0
2019-03-16,South Carolina,0,2,0,2,0.0
2019-03-16,Alaska,2,0,0,2,1.0
2019-03-16,Arizona,0,1,2,3,0.3333333333333333
2019-03-16,Delaware,1,1,0,2,0.5
2019-03-16,Oregon,0,1,0,1,0.0
2019-03-16,Louisiana,1,1,2,4,0.5
2019-03-16,Arkansas,1,3,1,5,0.30000000000000004
2019-03-16,New York,2,0,1,3,0.8333333333333333
2019-03-16,Massachusetts,1,1,4,6,0.5
2019-03-16,Florida,0,2,3,5,0.3
2019-03-16,Illinois,2,0,0,2,1.0
2019-03-16,Nebraska,1,1,2,4,0.5
2019-03-16,Minnesota,1,0,0,1,1.0
2019-03-16,Michigan,0,1,0,1,0.0
2019-03-16,Oklahoma,0,0,1,1,0.5
2019-03-16,Connecticut,1,0,0,1,1.0
2019-03-16,Missouri,0,1,0,1,0.0
2019-03-15,Florida,3,4,5,12,0.45833333333333337
2019-03-15,California,11,2,13,26,0.6730769230769231
2019-03-15,Alaska,3,5,2,10,0.4
2019-03-15,Louisiana,7,3,2,12,0.6666666666666667
2019-03-15,Colorado,1,2,9,12,0.4583333333333333
2019-03-15,Hawaii,5,0,7,12,0.7083333333333334
2019-03-15,Massachusetts,9,5,5,19,0.6052631578947368
2019-03-15,Iowa,0,3,0,3,0.0
2019-03-15,Indiana,5,2,4,11,0.6363636363636364
2019-03-15,Missouri,3,1,1,5,0.7
2019-03-15,Utah,0,0,1,1,0.5
2019-03-15,Illinois,0,4,1,5,0.1
2019-03-15,Georgia,7,1,6,14,0.7142857142857143
2019-03-15,New York,0,0,2,2,0.5
2019-03-15,Delaware,5,0,2,7,0.8571428571428572
2019-03-15,Alabama,3,3,2,8,0.5
2019-03-15,Arkansas,2,1,5,8,0.5625
2019-03-15,Arizona,4,2,3,9,0.611111111111111
2019-03-15,Oregon,1,0,1,2,0.75
2019-03-15,Texas,1,5,3,9,0.2777777777777778
2019-03-15,Washington,2,1,1,4,0.625
2019-03-15,Nebraska,3,0,4,7,0.7142857142857142
2019-03-15,New Jersey,0,0,1,1,0.5
2019-03-15,Virginia,1,0,0,1,1.0
2019-03-15,Idaho,1,0,0,1,1.0
2019-03-15,Rhode Island,0,1,0,1,0.0
2019-03-15,Maryland,1,0,0,1,1.0
2019-03-15,Michigan,0,1,0,1,0.0
2019-03-15,Pennsylvania,2,0,2,4,0.75
2019-03-15,Maine,0,1,0,1,0.0
2019-03-15,South Carolina,1,0,0,1,1.0
2019-03-14,California,2,4,7,13,0.4230769230769231
2019-03-14,Arizona,0,3,4,7,0.2857142857142857
2019-03-14,Indiana,0,1,2,3,0.3333333333333333
2019-03-14,Florida,4,2,2,8,0.625
2019-03-14,Michigan,0,1,1,2,0.25
2019-03-14,Colorado,3,4,2,9,0.4444444444444444
2019-03-14,Virginia,0,0,1,1,0.5
2019-03-14,Illinois,0,3,3,6,0.25
2019-03-14,Arkansas,1,1,8,10,0.5
2019-03-14,Texas,0,2,2,4,0.25
2019-03-14,Alabama,5,3,1,9,0.6111111111111112
2019-03-14,Kansas,1,0,0,1,1.0
2019-03-14,Alaska,2,2,3,7,0.5
2019-03-14,New York,0,0,2,2,0.5
2019-03-14,Maine,1,1,0,2,0.5
2019-03-14,Georgia,4,1,1,6,0.75
2019-03-14,Hawaii,2,0,1,3,0.8333333333333333
2019-03-14,Massachusetts,3,0,3,6,0.75
2019-03-14,Minnesota,2,0,0,2,1.0
2019-03-14,Missouri,0,0,2,2,0.5
2019-03-14,Louisiana,0,1,0,1,0.0
2019-03-14,Iowa,3,0,2,5,0.8
2019-03-14,Nebraska,0,1,2,3,0.3333333333333333
2019-03-14,Idaho,0,0,1,1,0.5
2019-03-14,North Carolina,1,0,0,1,1.0
2019-03-14,Nevada,0,0,1,1,0.5
2019-03-14,Connecticut,0,0,1,1,0.5
2019-03-14,Maryland,0,1,0,1,0.0
2019-03-14,Oklahoma,0,1,0,1,0.0
2019-03-14,South Carolina,0,1,0,1,0.0
2019-03-14,Delaware,0,1,1,2,0.25
2019-03-14,New Hampshire,1,0,0,1,1.0
2019-03-14,Oregon,0,0,1,1,0.5
2019-03-13,Louisiana,1,0,2,3,0.6666666666666666
2019-03-13,California,2,6,6,14,0.3571428571428571
2019-03-13,Colorado,0,5,5,10,0.25
2019-03-13,Indiana,0,2,3,5,0.3
2019-03-13,Arizona,0,2,1,3,0.16666666666666666
2019-03-13,Texas,1,2,1,4,0.375
2019-03-13,Florida,1,1,3,5,0.5
2019-03-13,Illinois,0,1,1,2,0.25
2019-03-13,Pennsylvania,0,0,1,1,0.5
2019-03-13,New York,1,1,3,5,0.5
2019-03-13,Alabama,0,0,2,2,0.5
2019-03-13,Arkansas,0,3,1,4,0.125
2019-03-13,Kentucky,1,1,1,3,0.5
2019-03-13,Massachusetts,2,2,1,5,0.5
2019-03-13,Kansas,0,1,0,1,0.0
2019-03-13,Idaho,0,1,0,1,0.0
2019-03-13,Hawaii,1,1,2,4,0.5
2019-03-13,Washington,0,1,0,1,0.0
2019-03-13,Delaware,0,1,2,3,0.3333333333333333
2019-03-13,Oregon,2,0,0,2,1.0
2019-03-13,Georgia,0,0,1,1,0.5
2019-03-13,Ohio,0,0,1,1,0.5
2019-03-13,New Jersey,0,0,1,1,0.5
2019-03-12,Indiana,2,5,2,9,0.3333333333333333
2019-03-12,Virginia,0,1,0,1,0.0
2019-03-12,Arkansas,1,3,6,10,0.4
2019-03-12,Delaware,0,1,2,3,0.3333333333333333
2019-03-12,Georgia,2,1,0,3,0.6666666666666666
2019-03-12,California,10,5,11,26,0.5961538461538461
2019-03-12,Connecticut,0,1,1,2,0.25
2019-03-12,Florida,2,1,5,8,0.5625
2019-03-12,Alaska,0,2,3,5,0.3
2019-03-12,Texas,2,1,2,5,0.6000000000000001
2019-03-12,Arizona,0,0,2,2,0.5
2019-03-12,Maine,1,1,0,2,0.5
2019-03-12,Alabama,1,3,3,7,0.3571428571428571
2019-03-12,New York,1,1,1,3,0.5
2019-03-12,New Jersey,0,0,1,1,0.5
2019-03-12,Illinois,0,1,2,3,0.3333333333333333
2019-03-12,Colorado,1,3,0,4,0.25
2019-03-12,Oregon,1,0,0,1,1.0
2019-03-12,Pennsylvania,1,0,0,1,1.0
2019-03-12,Hawaii,2,0,1,3,0.8333333333333333
2019-03-12,Massachusetts,3,0,1,4,0.875
2019-03-12,Nevada,0,1,0,1,0.0
2019-03-12,Iowa,0,1,1,2,0.25
2019-03-12,Missouri,0,2,0,2,0.0
2019-03-12,North Carolina,0,1,0,1,0.0
2019-03-12,Nebraska,1,1,0,2,0.5
2019-03-12,Louisiana,0,1,1,2,0.25
2019-03-12,Michigan,0,0,1,1,0.5
2019-03-12,Washington,1,0,0,1,1.0
2019-03-11,Louisiana,2,2,0,4,0.5
2019-03-11,Alabama,2,1,1,4,0.625
2019-03-11,Hawaii,1,1,4,6,0.5
2019-03-11,California,1,4,5,10,0.35
2019-03-11,Alaska,1,0,4,5,0.6000000000000001
2019-03-11,Arkansas,3,1,3,7,0.6428571428571428
2019-03-11,Arizona,0,0,3,3,0.5
2019-03-11,Delaware,1,0,0,1,1.0
2019-03-11,Oregon,0,0,1,1,0.5
2019-03-11,Illinois,0,1,4,5,0.4
2019-03-11,Texas,0,1,1,2,0.25
2019-03-11,Indiana,3,2,1,6,0.5833333333333334
2019-03-11,South Carolina,0,0,1,1,0.5
2019-03-11,Minnesota,0,0,1,1,0.5
2019-03-11,Iowa,0,0,2,2,0.5
2019-03-11,Washington,0,2,0,2,0.0
2019-03-11,North Carolina,1,0,0,1,1.0
2019-03-11,Colorado,1,0,1,2,0.75
2019-03-11,Michigan,1,0,0,1,1.0
2019-03-11,Florida,0,0,1,1,0.5
2019-03-10,Missouri,0,2,1,3,0.16666666666666666
2019-03-10,Hawaii,1,2,2,5,0.4
2019-03-10,California,5,8,4,17,0.4117647058823529
2019-03-10,Nebraska,0,2,0,2,0.0
2019-03-10,Arkansas,1,0,3,4,0.625
2019-03-10,Indiana,0,2,4,6,0.3333333333333333
2019-03-10,Delaware,1,1,2,4,0.5
2019-03-10,Alabama,0,0,5,5,0.5
2019-03-10,Florida,0,1,2,3,0.3333333333333333
2019-03-10,North Carolina,1,0,0,1,1.0
2019-03-10,New York,0,1,1,2,0.25
2019-03-10,Georgia,1,0,0,1,1.0
2019-03-10,Texas,1,1,0,2,0.5
2019-03-10,Colorado,1,0,0,1,1.0
2019-03-10,Louisiana,0,1,1,2,0.25
2019-03-10,Illinois,0,0,1,1,0.5
2019-03-10,Massachusetts,1,2,0,3,0.3333333333333333
2019-03-10,Arizona,2,0,0,2,1.0
2019-03-10,Maryland,0,0,1,1,0.5
2019-03-10,Kansas,0,1,0,1,0.0
2019-03-09,Alaska,0,1,1,2,0.25
2019-03-09,Kansas,0,0,1,1,0.5
2019-03-09,Connecticut,1,0,0,1,1.0
2019-03-09,Alabama,3,1,2,6,0.6666666666666666
2019-03-09,Hawaii,0,2,1,3,0.16666666666666666
2019-03-09,Arkansas,1,0,1,2,0.75
2019-03-09,Iowa,1,2,1,4,0.375
2019-03-09,Indiana,1,1,1,3,0.5
2019-03-09,California,1,4,3,8,0.3125
2019-03-09,Colorado,2,0,1,3,0.8333333333333333
2019-03-09,Florida,1,1,2,4,0.5
2019-03-09,New York,0,0,1,1,0.5
2019-03-09,Massachusetts,2,1,3,6,0.5833333333333333
2019-03-09,Illinois,0,1,0,1,0.0
2019-03-09,Michigan,0,1,0,1,0.0
2019-03-09,Arizona,0,0,1,1,0.5
2019-03-09,Texas,0,1,2,3,0.3333333333333333
2019-03-09,Nebraska,0,0,1,1,0.5
2019-03-09,Missouri,0,0,1,1,0.5
2019-03-09,Georgia,0,1,0,1,0.0
2019-03-09,New Hampshire,0,1,0,1,0.0
2019-03-08,Indiana,2,1,0,3,0.6666666666666666
2019-03-08,Louisiana,0,1,0,1,0.0
2019-03-08,Arizona,1,1,1,3,0.5
2019-03-08,Illinois,0,1,1,2,0.25
2019-03-08,Delaware,1,0,0,1,1.0
2019-03-08,California,9,4,7,20,0.625
2019-03-08,Georgia,0,0,4,4,0.5
2019-03-08,Alabama,2,2,5,9,0.5
2019-03-08,Arkansas,2,2,4,8,0.5
2019-03-08,Nebraska,0,1,1,2,0.25
2019-03-08,Colorado,0,2,1,3,0.16666666666666666
2019-03-08,Florida,1,3,2,6,0.3333333333333333
2019-03-08,Idaho,0,1,0,1,0.0
2019-03-08,Massachusetts,2,0,0,2,1.0
2019-03-08,New York,0,1,1,2,0.25
2019-03-08,Texas,0,1,0,1,0.0
2019-03-08,Washington,0,0,2,2,0.5
2019-03-08,Ohio,0,0,1,1,0.5
2019-03-08,Hawaii,0,0,1,1,0.5
2019-03-08,Iowa,0,2,0,2,0.0
2019-03-08,Missouri,0,1,0,1,0.0
2019-03-08,Oregon,0,1,0,1,0.0
2019-03-08,Kansas,1,0,0,1,1.0
2019-03-08,Alaska,0,2,0,2,0.0
2019-03-07,Iowa,1,0,4,5,0.6000000000000001
2019-03-07,Missouri,4,0,0,4,1.0
2019-03-07,Utah,0,1,0,1,0.0
2019-03-07,Indiana,1,1,2,4,0.5
2019-03-07,Georgia,0,1,3,4,0.375
2019-03-07,Texas,0,1,1,2,0.25
2019-03-07,Washington,1,2,0,3,0.3333333333333333
2019-03-07,Oregon,0,1,0,1,0.0
2019-03-07,Michigan,1,0,0,1,1.0
2019-03-07,Hawaii,2,1,2,5,0.6000000000000001
2019-03-07,New York,0,1,2,3,0.3333333333333333
2019-03-07,California,2,2,4,8,0.5
2019-03-07,Florida,3,1,2,6,0.6666666666666666
2019-03-07,Arkansas,2,0,2,4,0.75
2019-03-07,Nebraska,1,1,1,3,0.5
2019-03-07,Colorado,0,1,1,2,0.25
2019-03-07,Pennsylvania,1,0,0,1,1.0
2019-03-07,Illinois,0,0,2,2,0.5
2019-03-07,Alabama,2,4,2,8,0.375
2019-03-07,North Carolina,3,0,0,3,1.0
2019-03-07,Alaska,1,1,0,2,0.5
2019-03-07,Louisiana,1,0,0,1,1.0
2019-03-07,Arizona,0,1,0,1,0.0
2019-03-07,Massachusetts,2,2,2,6,0.5
2019-03-07,Delaware,1,0,0,1,1.0
2019-03-07,Minnesota,0,1,0,1,0.0
2019-03-07,Idaho,0,0,1,1,0.5
2019-03-06,Arkansas,2,3,5,10,0.45
2019-03-06,Colorado,2,1,1,4,0.625
2019-03-06,Texas,1,1,1,3,0.5
2019-03-06,Indiana,1,5,10,16,0.375
2019-03-06,Missouri,1,1,0,2,0.5
2019-03-06,Illinois,2,0,3,5,0.7
2019-03-06,Alabama,7,3,4,14,0.6428571428571428
2019-03-06,Louisiana,1,1,1,3,0.5
2019-03-06,Hawaii,0,4,2,6,0.16666666666666666
2019-03-06,Georgia,0,2,3,5,0.3
2019-03-06,Alaska,2,0,1,3,0.8333333333333333
2019-03-06,North Carolina,1,1,0,2,0.5
2019-03-06,Florida,1,3,1,5,0.30000000000000004
2019-03-06,California,15,9,13,37,0.5810810810810811
2019-03-06,Delaware,1,1,1,3,0.5
2019-03-06,Oregon,0,2,0,2,0.0
2019-03-06,Washington,0,2,1,3,0.16666666666666666
2019-03-06,Massachusetts,0,3,0,3,0.0
2019-03-06,Iowa,0,2,0,2,0.0
2019-03-06,Nebraska,1,1,1,3,0.5
2019-03-06,Pennsylvania,0,1,0,1,0.0
2019-03-06,Maryland,0,1,0,1,0.0
2019-03-06,Virginia,0,0,1,1,0.5
2019-03-06,Nevada,0,0,1,1,0.5
2019-03-06,Arizona,1,1,0,2,0.5
2019-03-06,New York,0,0,2,2,0.5
2019-03-06,Ohio,0,0,1,1,0.5
2019-03-06,Wisconsin,0,1,0,1,0.0
2019-03-05,California,10,7,7,24,0.5625
2019-03-05,New York,0,2,5,7,0.35714285714285715
2019-03-05,Illinois,1,0,7,8,0.5625
2019-03-05,Massachusetts,3,2,5,10,0.55
2019-03-05,Arkansas,3,2,7,12,0.5416666666666667
2019-03-05,Alabama,4,6,5,15,0.43333333333333335
2019-03-05,Oregon,1,0,0,1,1.0
2019-03-05,Missouri,3,2,0,5,0.6
2019-03-05,Alaska,1,0,4,5,0.6000000000000001
2019-03-05,Hawaii,4,2,7,13,0.5769230769230769
2019-03-05,Rhode Island,0,0,1,1,0.5
2019-03-05,Louisiana,2,1,1,4,0.625
2019-03-05,Indiana,4,8,3,15,0.3666666666666667
2019-03-05,Maine,0,0,2,2,0.5
2019-03-05,Georgia,0,1,2,3,0.3333333333333333
2019-03-05,Utah,0,1,1,2,0.25
2019-03-05,Pennsylvania,0,1,0,1,0.0
2019-03-05,Texas,3,1,7,11,0.5909090909090908
2019-03-05,Colorado,0,2,2,4,0.25
2019-03-05,Arizona,0,2,0,2,0.0
2019-03-05,Florida,2,3,4,9,0.4444444444444444
2019-03-05,Ohio,1,1,1,3,0.5
2019-03-05,North Carolina,0,1,1,2,0.25
2019-03-05,Delaware,0,0,2,2,0.5
2019-03-05,Maryland,1,0,0,1,1.0
2019-03-05,Idaho,1,0,1,2,0.75
2019-03-05,Nebraska,1,2,1,4,0.375
2019-03-05,Kentucky,0,0,1,1,0.5
2019-03-05,Kansas,0,1,1,2,0.25
2019-03-05,Iowa,0,0,1,1,0.5
2019-03-05,Washington,0,0,1,1,0.5
2019-03-04,Oregon,1,2,1,4,0.375
2019-03-04,Massachusetts,1,3,4,8,0.375
2019-03-04,California,5,9,3,17,0.3823529411764706
2019-03-04,North Carolina,0,0,1,1,0.5
2019-03-04,Washington,0,0,4,4,0.5
2019-03-04,Alaska,4,2,0,6,0.6666666666666666
2019-03-04,Wisconsin,1,0,0,1,1.0
2019-03-04,Arkansas,4,3,6,13,0.5384615384615385
2019-03-04,Colorado,3,3,4,10,0.5
2019-03-04,New York,1,2,2,5,0.4
2019-03-04,Florida,1,4,4,9,0.3333333333333333
2019-03-04,Texas,1,3,6,10,0.4
2019-03-04,Indiana,0,6,8,14,0.2857142857142857
2019-03-04,Louisiana,2,6,5,13,0.34615384615384615
2019-03-04,New Hampshire,2,0,0,2,1.0
2019-03-04,Georgia,1,1,8,10,0.5
2019-03-04,Delaware,2,0,4,6,0.6666666666666666
2019-03-04,Iowa,3,1,2,6,0.6666666666666666
2019-03-04,Alabama,3,2,7,12,0.5416666666666667
2019-03-04,Pennsylvania,0,1,1,2,0.25
2019-03-04,Hawaii,1,5,8,14,0.3571428571428571
2019-03-04,Illinois,1,1,7,9,0.5
2019-03-04,Kansas,2,3,2,7,0.42857142857142855
2019-03-04,Kentucky,0,1,1,2,0.25
2019-03-04,Nebraska,2,1,0,3,0.6666666666666666
2019-03-04,Michigan,0,1,3,4,0.375
2019-03-04,Rhode Island,0,0,1,1,0.5
2019-03-04,Arizona,4,0,0,4,1.0
2019-03-04,North Dakota,0,0,1,1,0.5
2019-03-04,Missouri,0,0,2,2,0.5
2019-03-04,Montana,0,0,1,1,0.5
2019-03-04,Minnesota,1,0,0,1,1.0
2019-03-03,California,6,5,5,16,0.53125
2019-03-03,Colorado,2,2,1,5,0.5
2019-03-03,Florida,1,3,4,8,0.375
2019-03-03,Alabama,5,7,5,17,0.4411764705882353
2019-03-03,Massachusetts,2,3,4,9,0.4444444444444444
2019-03-03,Nebraska,1,3,3,7,0.3571428571428571
2019-03-03,Missouri,0,4,2,6,0.16666666666666666
2019-03-03,Arkansas,2,5,3,10,0.35
2019-03-03,Delaware,0,0,2,2,0.5
2019-03-03,Idaho,0,1,1,2,0.25
2019-03-03,Hawaii,1,1,3,5,0.5
2019-03-03,Alaska,1,2,2,5,0.4
2019-03-03,Indiana,1,3,8,12,0.41666666666666663
2019-03-03,Virginia,2,0,0,2,1.0
2019-03-03,Georgia,0,2,3,5,0.3
2019-03-03,Maryland,1,0,0,1,1.0
2019-03-03,Iowa,1,2,1,4,0.375
2019-03-03,Kansas,1,1,1,3,0.5
2019-03-03,New York,1,1,2,4,0.5
2019-03-03,Oregon,0,0,2,2,0.5
2019-03-03,Louisiana,1,1,2,4,0.5
2019-03-03,Texas,0,1,1,2,0.25
2019-03-03,Arizona,0,3,1,4,0.125
2019-03-03,Ohio,0,1,1,2,0.25
2019-03-03,New Jersey,0,1,0,1,0.0
2019-03-03,Illinois,0,1,1,2,0.25
2019-03-03,Kentucky,0,1,0,1,0.0
2019-03-02,Arkansas,4,3,4,11,0.5454545454545454
2019-03-02,Washington,0,1,2,3,0.3333333333333333
2019-03-02,Indiana,1,5,3,9,0.2777777777777778
2019-03-02,Delaware,0,3,0,3,0.0
2019-03-02,California,5,8,9,22,0.4318181818181818
2019-03-02,Arizona,0,1,1,2,0.25
2019-03-02,Alabama,0,4,5,9,0.2777777777777778
2019-03-02,New Jersey,0,0,2,2,0.5
2019-03-02,Minnesota,1,1,0,2,0.5
2019-03-02,Nebraska,2,0,1,3,0.8333333333333333
2019-03-02,Missouri,0,0,2,2,0.5
2019-03-02,Texas,0,1,3,4,0.375
2019-03-02,Louisiana,2,0,2,4,0.75
2019-03-02,Michigan,0,0,1,1,0.5
2019-03-02,Utah,0,0,1,1,0.5
2019-03-02,Colorado,1,2,0,3,0.3333333333333333
2019-03-02,Hawaii,1,3,2,6,0.3333333333333333
2019-03-02,Massachusetts,1,1,3,5,0.5
2019-03-02,New York,1,1,2,4,0.5
2019-03-02,Pennsylvania,0,1,0,1,0.0
2019-03-02,Florida,0,1,2,3,0.3333333333333333
2019-03-02,Illinois,0,1,2,3,0.3333333333333333
2019-03-02,Alaska,0,3,0,3,0.0
2019-03-02,Kansas,0,0,1,1,0.5
2019-03-02,Georgia,0,1,2,3,0.3333333333333333
2019-03-02,Oregon,0,0,1,1,0.5
2019-03-02,Virginia,0,2,0,2,0.0
2019-03-02,South Carolina,1,0,0,1,1.0
2019-03-02,Idaho,0,1,0,1,0.0
2019-03-02,North Dakota,0,0,1,1,0.5
2019-03-02,Oklahoma,0,0,1,1,0.5
2019-03-02,Ohio,0,1,0,1,0.0
2019-03-01,Indiana,2,3,10,15,0.4666666666666667
2019-03-01,Texas,1,0,5,6,0.5833333333333334
2019-03-01,California,8,8,13,29,0.5
2019-03-01,Louisiana,0,1,3,4,0.375
2019-03-01,Alabama,6,5,5,16,0.53125
2019-03-01,Nebraska,1,2,2,5,0.4
2019-03-01,Georgia,1,4,3,8,0.3125
2019-03-01,Arkansas,4,6,3,13,0.42307692307692313
2019-03-01,Colorado,1,5,4,10,0.30000000000000004
2019-03-01,North Carolina,1,1,0,2,0.5
2019-03-01,Ohio,0,0,2,2,0.5
2019-03-01,Massachusetts,1,3,5,9,0.3888888888888889
2019-03-01,Florida,0,0,5,5,0.5
2019-03-01,Illinois,1,2,3,6,0.41666666666666663
2019-03-01,Delaware,0,2,4,6,0.3333333333333333
2019-03-01,Arizona,1,1,3,5,0.5
2019-03-01,Alaska,4,1,1,6,0.75
2019-03-01,Iowa,1,2,4,7,0.42857142857142855
2019-03-01,New Jersey,0,0,1,1,0.5
2019-03-01,Minnesota,0,1,1,2,0.25
2019-03-01,Kentucky,1,0,1,2,0.75
2019-03-01,Missouri,1,1,0,2,0.5
2019-03-01,Washington,0,3,1,4,0.125
2019-03-01,Hawaii,0,2,1,3,0.16666666666666666
2019-03-01,New York,0,0,1,1,0.5
2019-03-01,Virginia,0,0,1,1,0.5
2019-03-01,Oklahoma,0,1,0,1,0.0
2019-03-01,Michigan,0,2,0,2,0.0
2019-02-28,Alaska,0,0,2,2,0.5
2019-02-28,California,9,7,13,29,0.5344827586206897
2019-02-28,Georgia,0,1,2,3,0.3333333333333333
2019-02-28,Michigan,0,1,2,3,0.3333333333333333
2019-02-28,Arkansas,1,8,1,10,0.15000000000000002
2019-02-28,Illinois,1,0,1,2,0.75
2019-02-28,Iowa,1,3,1,5,0.30000000000000004
2019-02-28,Pennsylvania,1,1,2,4,0.5
2019-02-28,Louisiana,4,0,0,4,1.0
2019-02-28,Hawaii,0,0,5,5,0.5
2019-02-28,Texas,0,1,2,3,0.3333333333333333
2019-02-28,Arizona,2,1,3,6,0.5833333333333333
2019-02-28,Missouri,1,1,1,3,0.5
2019-02-28,Indiana,0,0,4,4,0.5
2019-02-28,Wisconsin,0,1,0,1,0.0
2019-02-28,Alabama,5,5,4,14,0.5
2019-02-28,Colorado,2,4,3,9,0.38888888888888884
2019-02-28,New Jersey,0,1,1,2,0.25
2019-02-28,Ohio,1,0,2,3,0.6666666666666666
2019-02-28,Florida,0,1,1,2,0.25
2019-02-28,Massachusetts,1,0,2,3,0.6666666666666666
2019-02-28,Oregon,0,0,1,1,0.5
2019-02-28,Connecticut,0,0,3,3,0.5
2019-02-28,New York,2,1,4,7,0.5714285714285714
2019-02-28,Kansas,0,0,3,3,0.5
2019-02-28,Delaware,0,0,1,1,0.5
2019-02-28,Idaho,1,0,0,1,1.0
2019-02-28,Washington,1,0,0,1,1.0
2019-02-28,Maine,0,0,1,1,0.5
2019-02-28,South Carolina,1,1,0,2,0.5
2019-02-28,Nebraska,0,1,0,1,0.0
2019-02-28,Virginia,1,0,0,1,1.0
2019-02-27,Arizona,2,2,2,6,0.5
2019-02-27,Colorado,4,0,2,6,0.8333333333333333
2019-02-27,Illinois,0,3,3,6,0.25
2019-02-27,Iowa,0,1,1,2,0.25
2019-02-27,Indiana,3,4,1,8,0.4375
2019-02-27,Alabama,2,7,8,17,0.3529411764705882
2019-02-27,Washington,0,3,0,3,0.0
2019-02-27,Hawaii,4,2,3,9,0.611111111111111
2019-02-27,Texas,2,1,1,4,0.625
2019-02-27,Maine,0,0,1,1,0.5
2019-02-27,California,6,5,12,23,0.5217391304347826
2019-02-27,Alaska,2,1,1,4,0.625
2019-02-27,Delaware,2,2,1,5,0.5
2019-02-27,Utah,0,1,0,1,0.0
2019-02-27,Pennsylvania,0,0,1,1,0.5
2019-02-27,Florida,3,2,0,5,0.6
2019-02-27,Missouri,0,1,1,2,0.25
2019-02-27,Arkansas,1,3,4,8,0.375
2019-02-27,Oklahoma,0,0,2,2,0.5
2019-02-27,Rhode Island,1,0,0,1,1.0
2019-02-27,Georgia,1,1,1,3,0.5
2019-02-27,Michigan,0,1,1,2,0.25
2019-02-27,Massachusetts,4,0,1,5,0.9
2019-02-27,Louisiana,1,1,1,3,0.5
2019-02-27,New Jersey,0,0,1,1,0.5
2019-02-27,Virginia,0,0,1,1,0.5
2019-02-27,Nebraska,1,0,2,3,0.6666666666666666
2019-02-26,Illinois,0,5,4,9,0.2222222222222222
2019-02-26,Colorado,2,3,4,9,0.4444444444444444
2019-02-26,Arkansas,1,4,10,15,0.39999999999999997
2019-02-26,California,7,6,12,25,0.52
2019-02-26,Oregon,0,0,3,3,0.5
2019-02-26,Nebraska,1,2,3,6,0.41666666666666663
2019-02-26,New York,0,1,2,3,0.3333333333333333
2019-02-26,Texas,1,2,5,8,0.4375
2019-02-26,Virginia,0,0,2,2,0.5
2019-02-26,Connecticut,1,1,0,2,0.5
2019-02-26,Indiana,1,4,2,7,0.2857142857142857
2019-02-26,Delaware,1,0,2,3,0.6666666666666666
2019-02-26,Michigan,1,1,1,3,0.5
2019-02-26,Florida,1,2,6,9,0.4444444444444444
2019-02-26,Iowa,2,0,1,3,0.8333333333333333
2019-02-26,Alabama,6,5,11,22,0.5227272727272727
2019-02-26,Massachusetts,0,2,2,4,0.25
2019-02-26,Georgia,1,2,1,4,0.375
2019-02-26,Hawaii,2,0,4,6,0.6666666666666666
2019-02-26,Arizona,5,4,1,10,0.55
2019-02-26,Kansas,0,1,1,2,0.25
2019-02-26,Washington,0,0,2,2,0.5
2019-02-26,North Dakota,0,0,1,1,0.5
2019-02-26,New Mexico,0,0,1,1,0.5
2019-02-26,Missouri,2,1,0,3,0.6666666666666666
2019-02-26,Oklahoma,0,0,2,2,0.5
2019-02-26,Pennsylvania,0,3,0,3,0.0
2019-02-26,Nevada,0,0,2,2,0.5
2019-02-26,Idaho,1,0,0,1,1.0
2019-02-26,Maryland,1,0,1,2,0.75
2019-02-26,Minnesota,0,0,1,1,0.5
2019-02-26,Alaska,1,1,0,2,0.5
2019-02-26,North Carolina,0,0,1,1,0.5
2019-02-26,Ohio,0,1,0,1,0.0
2019-02-25,California,7,10,18,35,0.45714285714285713
2019-02-25,Louisiana,10,1,1,12,0.875
2019-02-25,Alabama,4,10,10,24,0.375
2019-02-25,Florida,5,3,7,15,0.5666666666666667
2019-02-25,Iowa,1,2,2,5,0.4
2019-02-25,Massachusetts,3,3,5,11,0.5
2019-02-25,New York,6,1,2,9,0.7777777777777777
2019-02-25,Texas,1,4,5,10,0.35
2019-02-25,Hawaii,3,3,2,8,0.5
2019-02-25,Colorado,1,8,4,13,0.23076923076923078
2019-02-25,Pennsylvania,1,0,0,1,1.0
2019-02-25,Arkansas,2,5,9,16,0.40625
2019-02-25,Indiana,1,2,7,10,0.44999999999999996
2019-02-25,Kentucky,1,0,0,1,1.0
2019-02-25,Alaska,3,2,2,7,0.5714285714285714
2019-02-25,New Jersey,1,0,2,3,0.6666666666666666
2019-02-25,Washington,3,2,2,7,0.5714285714285714
2019-02-25,Arizona,4,1,1,6,0.75
2019-02-25,Illinois,2,4,1,7,0.3571428571428571
2019-02-25,Nebraska,0,0,4,4,0.5
2019-02-25,Georgia,3,1,4,8,0.625
2019-02-25,Mississippi,0,0,1,1,0.5
2019-02-25,New Mexico,0,1,0,1,0.0
2019-02-25,Delaware,1,1,0,2,0.5
2019-02-25,Virginia,2,0,1,3,0.8333333333333333
2019-02-25,Missouri,4,2,8,14,0.5714285714285714
2019-02-25,Michigan,0,2,4,6,0.3333333333333333
2019-02-25,Minnesota,0,0,2,2,0.5
2019-02-25,Connecticut,0,0,1,1,0.5
2019-02-25,Idaho,0,0,1,1,0.5
2019-02-25,Oregon,1,1,0,2,0.5
2019-02-25,Utah,0,1,0,1,0.0
2019-02-25,Kansas,0,0,1,1,0.5
2019-02-24,Colorado,3,3,9,15,0.5
2019-02-24,Iowa,0,3,1,4,0.125
2019-02-24,Indiana,3,5,3,11,0.40909090909090906
2019-02-24,Texas,2,3,5,10,0.45
2019-02-24,Alabama,4,3,11,18,0.5277777777777778
2019-02-24,Georgia,1,4,3,8,0.3125
2019-02-24,Delaware,0,1,4,5,0.4
2019-02-24,Washington,0,1,1,2,0.25
2019-02-24,Massachusetts,1,3,0,4,0.25
2019-02-24,Florida,0,2,1,3,0.16666666666666666
2019-02-24,California,8,12,5,25,0.42000000000000004
2019-02-24,New York,0,2,2,4,0.25
2019-02-24,Hawaii,6,3,1,10,0.65
2019-02-24,Missouri,3,16,7,26,0.25
2019-02-24,Nebraska,2,2,5,9,0.5
2019-02-24,Arkansas,0,3,3,6,0.25
2019-02-24,Illinois,0,2,4,6,0.3333333333333333
2019-02-24,Michigan,0,2,0,2,0.0
2019-02-24,Louisiana,0,0,1,1,0.5
2019-02-24,Mississippi,0,0,1,1,0.5
2019-02-24,Arizona,3,2,3,8,0.5625
2019-02-24,Alaska,3,2,2,7,0.5714285714285714
2019-02-24,South Carolina,0,0,1,1,0.5
2019-02-24,Oregon,0,1,1,2,0.25
2019-02-24,Minnesota,1,0,0,1,1.0
2019-02-24,Utah,0,1,0,1,0.0
2019-02-24,Nevada,0,1,0,1,0.0
2019-02-23,North Carolina,1,1,3,5,0.5
2019-02-23,California,6,12,11,29,0.39655172413793105
2019-02-23,Texas,1,1,2,4,0.5
2019-02-23,Arizona,5,3,11,19,0.5526315789473684
2019-02-23,Arkansas,4,4,8,16,0.5
2019-02-23,Pennsylvania,0,0,1,1,0.5
2019-02-23,Georgia,1,4,5,10,0.35
2019-02-23,Alabama,7,4,4,15,0.6
2019-02-23,Delaware,2,1,3,6,0.5833333333333333
2019-02-23,Utah,0,0,1,1,0.5
2019-02-23,Kentucky,1,1,0,2,0.5
2019-02-23,Virginia,0,0,1,1,0.5
2019-02-23,Colorado,2,6,3,11,0.3181818181818182
2019-02-23,Oregon,0,1,1,2,0.25
2019-02-23,Massachusetts,4,1,3,8,0.6875
2019-02-23,Iowa,1,0,2,3,0.6666666666666666
2019-02-23,Louisiana,0,0,3,3,0.5
2019-02-23,Kansas,1,0,0,1,1.0
2019-02-23,New York,7,0,2,9,0.8888888888888888
2019-02-23,Indiana,3,1,2,6,0.6666666666666666
2019-02-23,Nebraska,1,0,2,3,0.6666666666666666
2019-02-23,New Jersey,1,0,0,1,1.0
2019-02-23,Florida,6,3,1,10,0.65
2019-02-23,Hawaii,1,1,6,8,0.5
2019-02-23,Alaska,1,2,3,6,0.41666666666666663
2019-02-23,Washington,0,3,3,6,0.25
2019-02-23,Ohio,0,1,0,1,0.0
2019-02-23,Idaho,0,2,0,2,0.0
2019-02-23,Michigan,1,1,0,2,0.5
2019-02-23,Missouri,0,1,1,2,0.25
2019-02-23,Illinois,0,1,2,3,0.3333333333333333
2019-02-23,Connecticut,0,2,0,2,0.0
2019-02-22,Hawaii,2,5,4,11,0.36363636363636365
2019-02-22,Arkansas,3,5,5,13,0.42307692307692313
2019-02-22,Texas,1,0,4,5,0.6000000000000001
2019-02-22,Indiana,4,1,6,11,0.6363636363636364
2019-02-22,Florida,0,1,2,3,0.3333333333333333
2019-02-22,Illinois,2,0,2,4,0.75
2019-02-22,California,10,14,25,49,0.45918367346938777
2019-02-22,Louisiana,2,3,3,8,0.4375
2019-02-22,Alabama,3,11,8,22,0.3181818181818182
2019-02-22,Arizona,4,11,13,28,0.375
2019-02-22,New York,4,1,0,5,0.8
2019-02-22,Iowa,0,3,0,3,0.0
2019-02-22,Virginia,1,0,1,2,0.75
2019-02-22,Massachusetts,2,0,1,3,0.8333333333333333
2019-02-22,Oregon,1,0,3,4,0.625
2019-02-22,Missouri,1,0,3,4,0.625
2019-02-22,Pennsylvania,0,1,2,3,0.3333333333333333
2019-02-22,Delaware,2,0,3,5,0.7
2019-02-22,Colorado,2,3,1,6,0.41666666666666663
2019-02-22,Minnesota,1,0,1,2,0.75
2019-02-22,Nebraska,0,1,2,3,0.3333333333333333
2019-02-22,Alaska,2,0,2,4,0.75
2019-02-22,Michigan,3,0,3,6,0.75
2019-02-22,Idaho,1,0,1,2,0.75
2019-02-22,Kentucky,0,1,1,2,0.25
2019-02-22,Georgia,1,1,0,2,0.5
2019-02-22,Washington,0,0,1,1,0.5
2019-02-22,Maine,0,1,0,1,0.0
2019-02-22,Connecticut,0,0,2,2,0.5
2019-02-22,Nevada,0,1,0,1,0.0
2019-02-22,Kansas,0,0,1,1,0.5
2019-02-22,Oklahoma,0,1,0,1,0.0
2019-02-22,New Jersey,0,0,1,1,0.5
2019-02-22,Ohio,0,0,1,1,0.5
2019-02-22,North Carolina,0,0,1,1,0.5
2019-02-21,Indiana,2,5,8,15,0.4
2019-02-21,Texas,2,0,5,7,0.6428571428571428
2019-02-21,Louisiana,2,5,7,14,0.39285714285714285
2019-02-21,Alaska,1,8,4,13,0.23076923076923078
2019-02-21,Georgia,1,5,11,17,0.3823529411764706
2019-02-21,California,12,23,31,66,0.4166666666666667
2019-02-21,Illinois,3,2,5,10,0.55
2019-02-21,New York,1,4,4,9,0.3333333333333333
2019-02-21,Alabama,7,6,16,29,0.5172413793103449
2019-02-21,Florida,1,1,4,6,0.5
2019-02-21,Nebraska,0,2,5,7,0.35714285714285715
2019-02-21,Arizona,3,6,11,20,0.42500000000000004
2019-02-21,Hawaii,2,4,6,12,0.41666666666666663
2019-02-21,Arkansas,2,10,14,26,0.34615384615384615
2019-02-21,Oklahoma,0,0,1,1,0.5
2019-02-21,Washington,1,0,0,1,1.0
2019-02-21,Ohio,1,1,1,3,0.5
2019-02-21,Iowa,0,2,5,7,0.35714285714285715
2019-02-21,Maryland,1,0,0,1,1.0
2019-02-21,Massachusetts,1,1,6,8,0.5
2019-02-21,Nevada,0,1,5,6,0.4166666666666667
2019-02-21,Colorado,2,2,3,7,0.5
2019-02-21,Oregon,0,2,1,3,0.16666666666666666
2019-02-21,Utah,0,2,0,2,0.0
2019-02-21,Minnesota,0,1,2,3,0.3333333333333333
2019-02-21,New Jersey,0,1,0,1,0.0
2019-02-21,Delaware,2,2,2,6,0.5
2019-02-21,South Carolina,0,1,0,1,0.0
2019-02-21,Virginia,0,0,1,1,0.5
2019-02-21,Michigan,1,0,0,1,1.0
2019-02-21,Kansas,1,0,1,2,0.75
2019-02-21,North Carolina,0,0,1,1,0.5
2019-02-21,Missouri,0,1,1,2,0.25
2019-02-21,Connecticut,1,1,1,3,0.5
2019-02-21,North Dakota,0,0,1,1,0.5
2019-02-20,Georgia,1,3,5,9,0.3888888888888889
2019-02-20,Nevada,0,2,0,2,0.0
2019-02-20,Arkansas,2,6,8,16,0.375
2019-02-20,Hawaii,2,6,2,10,0.30000000000000004
2019-02-20,California,1,4,15,20,0.425
2019-02-20,Florida,3,0,3,6,0.75
2019-02-20,Arizona,2,2,3,7,0.5
2019-02-20,Alabama,1,5,5,11,0.3181818181818182
2019-02-20,Nebraska,0,0,1,1,0.5
2019-02-20,Iowa,2,0,2,4,0.75
2019-02-20,Texas,2,3,1,6,0.41666666666666663
2019-02-20,Alaska,2,1,1,4,0.625
2019-02-20,North Carolina,0,0,1,1,0.5
2019-02-20,Delaware,1,1,2,4,0.5
2019-02-20,Illinois,3,3,3,9,0.5
2019-02-20,Indiana,7,1,4,12,0.75
2019-02-20,Massachusetts,1,0,2,3,0.6666666666666666
2019-02-20,New York,1,0,0,1,1.0
2019-02-20,Kansas,0,0,1,1,0.5
2019-02-20,Colorado,2,0,3,5,0.7
2019-02-20,Idaho,2,0,0,2,1.0
2019-02-20,Michigan,1,0,0,1,1.0
2019-02-20,Louisiana,0,0,2,2,0.5
2019-02-20,Maryland,1,0,1,2,0.75
2019-02-20,Minnesota,2,0,0,2,1.0
2019-02-20,Missouri,1,2,1,4,0.375
2019-02-20,New Jersey,1,0,1,2,0.75
2019-02-20,Washington,1,0,1,2,0.75
2019-02-20,Pennsylvania,0,1,1,2,0.25
2019-02-20,Oregon,0,1,1,2,0.25
2019-02-20,Kentucky,0,1,0,1,0.0
2019-02-19,California,8,5,6,19,0.5789473684210527
2019-02-19,Texas,1,0,4,5,0.6000000000000001
2019-02-19,Massachusetts,1,3,2,6,0.3333333333333333
2019-02-19,New York,0,1,2,3,0.3333333333333333
2019-02-19,Arkansas,2,4,5,11,0.40909090909090906
2019-02-19,Oregon,2,0,0,2,1.0
2019-02-19,Iowa,0,0,1,1,0.5
2019-02-19,Alabama,2,4,7,13,0.4230769230769231
2019-02-19,Hawaii,1,2,5,8,0.4375
2019-02-19,Idaho,0,0,1,1,0.5
2019-02-19,Washington,1,1,2,4,0.5
2019-02-19,New Mexico,0,0,1,1,0.5
2019-02-19,Arizona,2,1,2,5,0.6000000000000001
2019-02-19,Colorado,0,4,3,7,0.21428571428571427
2019-02-19,Nebraska,0,0,2,2,0.5
2019-02-19,Delaware,0,1,2,3,0.3333333333333333
2019-02-19,Florida,2,1,0,3,0.6666666666666666
2019-02-19,Louisiana,0,0,4,4,0.5
2019-02-19,North Carolina,0,0,1,1,0.5
2019-02-19,Illinois,1,1,2,4,0.5
2019-02-19,Indiana,0,2,3,5,0.3
2019-02-19,Georgia,1,0,2,3,0.6666666666666666
2019-02-19,Minnesota,1,0,0,1,1.0
2019-02-19,Maryland,1,0,0,1,1.0
2019-02-19,Kentucky,0,0,1,1,0.5
2019-02-19,Pennsylvania,1,0,0,1,1.0
2019-02-19,Alaska,3,1,1,5,0.7
2019-02-19,Michigan,1,0,0,1,1.0
2019-02-19,Rhode Island,0,0,1,1,0.5
2019-02-19,Kansas,0,0,1,1,0.5
2019-02-18,Alabama,9,0,3,12,0.875
2019-02-18,Nebraska,4,1,3,8,0.6875
2019-02-18,Michigan,1,0,1,2,0.75
2019-02-18,Colorado,3,2,2,7,0.5714285714285714
2019-02-18,Louisiana,2,0,2,4,0.75
2019-02-18,Missouri,2,0,3,5,0.7
2019-02-18,Massachusetts,1,1,2,4,0.5
2019-02-18,California,4,4,6,14,0.5
2019-02-18,Washington,2,0,0,2,1.0
2019-02-18,Florida,1,2,3,6,0.41666666666666663
2019-02-18,Arkansas,2,4,6,12,0.41666666666666663
2019-02-18,Delaware,0,1,3,4,0.375
2019-02-18,Arizona,2,3,1,6,0.41666666666666663
2019-02-18,Indiana,1,2,2,5,0.4
2019-02-18,Illinois,1,2,0,3,0.3333333333333333
2019-02-18,Georgia,1,0,5,6,0.5833333333333334
2019-02-18,Hawaii,2,4,2,8,0.375
2019-02-18,Idaho,0,0,1,1,0.5
2019-02-18,Virginia,0,1,0,1,0.0
2019-02-18,Utah,0,0,1,1,0.5
2019-02-18,Nevada,0,0,1,1,0.5
2019-02-18,New Jersey,0,1,1,2,0.25
2019-02-18,Alaska,0,2,2,4,0.25
2019-02-18,New York,1,3,1,5,0.30000000000000004
2019-02-18,Iowa,0,0,1,1,0.5
2019-02-18,Texas,0,0,1,1,0.5
2019-02-18,Mississippi,0,1,0,1,0.0
2019-02-18,Oregon,0,0,1,1,0.5
2019-02-18,Kansas,1,0,0,1,1.0
2019-02-17,Missouri,2,0,1,3,0.8333333333333333
2019-02-17,Colorado,3,2,3,8,0.5625
2019-02-17,Alabama,6,8,4,18,0.4444444444444444
2019-02-17,Georgia,0,0,7,7,0.5
2019-02-17,California,2,1,8,11,0.5454545454545454
2019-02-17,Nebraska,0,1,1,2,0.25
2019-02-17,Illinois,1,0,1,2,0.75
2019-02-17,Arkansas,1,7,4,12,0.25
2019-02-17,Hawaii,0,1,2,3,0.3333333333333333
2019-02-17,Louisiana,0,2,2,4,0.25
2019-02-17,Arizona,0,2,3,5,0.3
2019-02-17,Iowa,0,2,2,4,0.25
2019-02-17,Kentucky,1,0,0,1,1.0
2019-02-17,Indiana,0,2,5,7,0.35714285714285715
2019-02-17,New Jersey,1,0,1,2,0.75
2019-02-17,Idaho,0,0,2,2,0.5
2019-02-17,Michigan,0,1,1,2,0.25
2019-02-17,Texas,0,0,1,1,0.5
2019-02-17,New York,0,0,2,2,0.5
2019-02-17,Washington,1,0,1,2,0.75
2019-02-17,Maryland,1,0,0,1,1.0
2019-02-17,Alaska,2,0,2,4,0.75
2019-02-17,Oregon,1,1,0,2,0.5
2019-02-17,Florida,0,2,2,4,0.25
2019-02-17,North Carolina,1,0,0,1,1.0
2019-02-17,Massachusetts,1,1,0,2,0.5
2019-02-17,North Dakota,0,0,1,1,0.5
2019-02-17,Delaware,0,0,1,1,0.5
2019-02-17,Virginia,1,0,0,1,1.0
2019-02-16,Maryland,0,0,5,5,0.5
2019-02-16,Delaware,1,0,0,1,1.0
2019-02-16,Florida,1,1,2,4,0.5
2019-02-16,Louisiana,0,1,1,2,0.25
2019-02-16,Arkansas,3,2,6,11,0.5454545454545454
2019-02-16,Nebraska,3,1,4,8,0.625
2019-02-16,California,6,10,4,20,0.4
2019-02-16,Utah,1,0,0,1,1.0
2019-02-16,Indiana,1,2,4,7,0.42857142857142855
2019-02-16,Idaho,0,1,1,2,0.25
2019-02-16,Hawaii,0,4,2,6,0.16666666666666666
2019-02-16,Massachusetts,1,1,1,3,0.5
2019-02-16,Iowa,0,0,2,2,0.5
2019-02-16,Colorado,0,2,3,5,0.3
2019-02-16,Alabama,3,2,3,8,0.5625
2019-02-16,Washington,3,1,0,4,0.75
2019-02-16,Missouri,0,1,1,2,0.25
2019-02-16,Texas,0,1,1,2,0.25
2019-02-16,Georgia,1,1,4,6,0.5
2019-02-16,Virginia,0,0,1,1,0.5
2019-02-16,New York,0,1,2,3,0.3333333333333333
2019-02-16,Oregon,0,0,1,1,0.5
2019-02-16,Oklahoma,0,0,1,1,0.5
2019-02-16,Kentucky,1,3,0,4,0.25
2019-02-16,Ohio,1,1,0,2,0.5
2019-02-16,New Jersey,1,2,0,3,0.3333333333333333
2019-02-16,Arizona,2,0,0,2,1.0
2019-02-16,West Virginia,0,1,0,1,0.0
2019-02-16,Illinois,0,1,0,1,0.0
2019-02-16,Alaska,0,0,2,2,0.5
2019-02-16,North Carolina,0,1,0,1,0.0
2019-02-16,Kansas,0,0,1,1,0.5
2019-02-15,Kansas,1,1,4,6,0.5
2019-02-15,Texas,1,2,4,7,0.42857142857142855
2019-02-15,Arkansas,2,3,7,12,0.45833333333333337
2019-02-15,New Mexico,0,5,0,5,0.0
2019-02-15,California,10,10,8,28,0.5
2019-02-15,Washington,2,2,1,5,0.5
2019-02-15,Hawaii,3,4,4,11,0.45454545454545453
2019-02-15,Arizona,4,3,2,9,0.5555555555555556
2019-02-15,Massachusetts,2,1,2,5,0.6000000000000001
2019-02-15,Nebraska,1,2,3,6,0.41666666666666663
2019-02-15,Indiana,5,2,5,12,0.625
2019-02-15,Maine,0,2,1,3,0.16666666666666666
2019-02-15,Alabama,3,5,8,16,0.4375
2019-02-15,Alaska,1,2,0,3,0.3333333333333333
2019-02-15,Georgia,3,0,0,3,1.0
2019-02-15,Ohio,1,0,1,2,0.75
2019-02-15,Michigan,2,0,2,4,0.75
2019-02-15,Illinois,1,0,0,1,1.0
2019-02-15,Missouri,3,0,2,5,0.8
2019-02-15,Colorado,3,0,2,5,0.8
2019-02-15,Florida,5,4,1,10,0.55
2019-02-15,Delaware,2,0,0,2,1.0
2019-02-15,Iowa,0,0,2,2,0.5
2019-02-15,West Virginia,0,2,0,2,0.0
2019-02-15,New York,2,1,1,4,0.625
2019-02-15,Idaho,0,0,1,1,0.5
2019-02-15,Louisiana,2,0,0,2,1.0
2019-02-15,North Carolina,0,0,1,1,0.5
2019-02-15,New Jersey,0,1,1,2,0.25
2019-02-15,Pennsylvania,0,2,0,2,0.0
2019-02-15,Oregon,0,1,0,1,0.0
2019-02-15,New Hampshire,0,0,1,1,0.5
2019-02-14,Massachusetts,5,1,2,8,0.75
2019-02-14,Arkansas,0,5,12,17,0.35294117647058826
2019-02-14,Georgia,0,1,7,8,0.4375
2019-02-14,California,14,12,19,45,0.5222222222222223
2019-02-14,Hawaii,7,4,4,15,0.6
2019-02-14,Louisiana,2,3,2,7,0.42857142857142855
2019-02-14,Indiana,4,3,1,8,0.5625
2019-02-14,Michigan,1,1,0,2,0.5
2019-02-14,Idaho,0,0,1,1,0.5
2019-02-14,Alabama,4,5,5,14,0.4642857142857143
2019-02-14,Illinois,1,3,3,7,0.3571428571428571
2019-02-14,Colorado,3,4,9,16,0.46875
2019-02-14,Alaska,1,0,1,2,0.75
2019-02-14,New York,1,3,4,8,0.375
2019-02-14,Kansas,0,0,2,2,0.5
2019-02-14,Oregon,0,2,4,6,0.3333333333333333
2019-02-14,Maryland,2,0,0,2,1.0
2019-02-14,Texas,2,3,5,10,0.45
2019-02-14,Delaware,1,1,4,6,0.5
2019-02-14,Florida,0,2,1,3,0.16666666666666666
2019-02-14,Pennsylvania,0,0,2,2,0.5
2019-02-14,Minnesota,1,0,0,1,1.0
2019-02-14,Iowa,0,0,2,2,0.5
2019-02-14,Arizona,0,1,1,2,0.25
2019-02-14,Kentucky,0,0,1,1,0.5
2019-02-14,South Carolina,1,0,0,1,1.0
2019-02-14,Rhode Island,1,0,0,1,1.0
2019-02-14,Washington,1,0,1,2,0.75
2019-02-14,New Hampshire,1,0,0,1,1.0
2019-02-14,Utah,0,1,0,1,0.0
2019-02-13,Florida,5,7,5,17,0.4411764705882353
2019-02-13,Nebraska,3,1,0,4,0.75
2019-02-13,Massachusetts,2,2,7,11,0.5
2019-02-13,Louisiana,2,1,4,7,0.5714285714285714
2019-02-13,Iowa,0,5,2,7,0.14285714285714285
2019-02-13,Alabama,6,7,12,25,0.48
2019-02-13,New York,0,1,2,3,0.3333333333333333
2019-02-13,Hawaii,7,4,7,18,0.5833333333333334
2019-02-13,California,6,10,15,31,0.43548387096774194
2019-02-13,Indiana,1,6,14,21,0.38095238095238093
2019-02-13,Texas,2,2,4,8,0.5
2019-02-13,Arkansas,5,7,10,22,0.45454545454545453
2019-02-13,Illinois,1,0,2,3,0.6666666666666666
2019-02-13,Utah,0,1,1,2,0.25
2019-02-13,Arizona,1,4,4,9,0.3333333333333333
2019-02-13,Idaho,1,0,3,4,0.625
2019-02-13,Pennsylvania,1,2,1,4,0.375
2019-02-13,Washington,0,1,1,2,0.25
2019-02-13,Colorado,3,2,2,7,0.5714285714285714
2019-02-13,Maryland,0,1,1,2,0.25
2019-02-13,Oregon,2,1,2,5,0.6000000000000001
2019-02-13,Delaware,0,3,1,4,0.125
2019-02-13,Maine,0,0,1,1,0.5
2019-02-13,Georgia,1,1,2,4,0.5
2019-02-13,Mississippi,1,0,0,1,1.0
2019-02-13,Ohio,0,2,1,3,0.16666666666666666
2019-02-13,Missouri,1,1,0,2,0.5
2019-02-13,Alaska,1,2,4,7,0.42857142857142855
2019-02-13,West Virginia,0,1,0,1,0.0
2019-02-13,Kansas,1,0,1,2,0.75
2019-02-13,North Dakota,1,0,0,1,1.0
2019-02-13,Michigan,0,1,0,1,0.0
2019-02-13,Minnesota,1,0,0,1,1.0
2019-02-12,Alabama,7,5,4,16,0.5625
2019-02-12,Illinois,3,1,8,12,0.5833333333333333
2019-02-12,California,7,12,11,30,0.41666666666666663
2019-02-12,Arkansas,4,2,10,16,0.5625
2019-02-12,Indiana,2,8,16,26,0.38461538461538464
2019-02-12,Missouri,0,1,2,3,0.3333333333333333
2019-02-12,Michigan,1,1,1,3,0.5
2019-02-12,Florida,4,4,6,14,0.5
2019-02-12,Louisiana,0,1,4,5,0.4
2019-02-12,Colorado,3,3,5,11,0.5
2019-02-12,Georgia,0,2,7,9,0.3888888888888889
2019-02-12,Hawaii,2,0,6,8,0.625
2019-02-12,Texas,1,1,6,8,0.5
2019-02-12,South Carolina,1,0,1,2,0.75
2019-02-12,Washington,2,2,4,8,0.5
2019-02-12,Nebraska,0,2,4,6,0.3333333333333333
2019-02-12,Massachusetts,3,4,6,13,0.46153846153846156
2019-02-12,Iowa,3,2,2,7,0.5714285714285714
2019-02-12,Delaware,0,0,4,4,0.5
2019-02-12,Ohio,0,1,1,2,0.25
2019-02-12,Pennsylvania,0,0,3,3,0.5
2019-02-12,Alaska,2,4,4,10,0.4
2019-02-12,Idaho,0,2,2,4,0.25
2019-02-12,Nevada,1,0,0,1,1.0
2019-02-12,Kansas,1,1,1,3,0.5
2019-02-12,New York,1,2,4,7,0.42857142857142855
2019-02-12,New Jersey,3,0,1,4,0.875
2019-02-12,Oregon,0,1,0,1,0.0
2019-02-12,Connecticut,1,2,1,4,0.375
2019-02-12,Wisconsin,0,0,2,2,0.5
2019-02-12,Maine,0,0,2,2,0.5
2019-02-12,Mississippi,0,1,0,1,0.0
2019-02-12,Oklahoma,0,0,1,1,0.5
2019-02-12,Arizona,0,2,3,5,0.3
2019-02-12,New Hampshire,1,0,0,1,1.0
2019-02-12,New Mexico,0,0,1,1,0.5
2019-02-11,Missouri,5,1,1,7,0.7857142857142857
2019-02-11,Alabama,7,10,15,32,0.453125
2019-02-11,Indiana,5,5,9,19,0.5
2019-02-11,Colorado,6,6,12,24,0.5
2019-02-11,California,11,25,16,52,0.3653846153846154
2019-02-11,Arkansas,4,12,20,36,0.3888888888888889
2019-02-11,New York,2,4,2,8,0.375
2019-02-11,Illinois,3,7,10,20,0.4
2019-02-11,Louisiana,1,4,5,10,0.35
2019-02-11,Arizona,3,4,1,8,0.4375
2019-02-11,Hawaii,5,13,10,28,0.35714285714285715
2019-02-11,Iowa,0,4,6,10,0.3
2019-02-11,Texas,4,4,9,17,0.5
2019-02-11,Massachusetts,1,1,7,9,0.5
2019-02-11,Kansas,1,0,1,2,0.75
2019-02-11,New Jersey,2,1,2,5,0.6000000000000001
2019-02-11,Washington,3,1,3,7,0.6428571428571428
2019-02-11,Florida,3,9,9,21,0.3571428571428571
2019-02-11,Idaho,2,3,3,8,0.4375
2019-02-11,Georgia,5,2,4,11,0.6363636363636364
2019-02-11,Nebraska,3,3,10,16,0.5
2019-02-11,Delaware,2,1,6,9,0.5555555555555556
2019-02-11,Oregon,2,1,1,4,0.625
2019-02-11,Connecticut,0,3,2,5,0.2
2019-02-11,Michigan,1,3,1,5,0.30000000000000004
2019-02-11,West Virginia,1,0,0,1,1.0
2019-02-11,Kentucky,0,1,2,3,0.3333333333333333
2019-02-11,Alaska,1,0,6,7,0.5714285714285714
2019-02-11,Nevada,0,1,0,1,0.0
2019-02-11,Pennsylvania,0,2,2,4,0.25
2019-02-11,Virginia,0,0,1,1,0.5
2019-02-11,Maryland,0,1,0,1,0.0
2019-02-11,Ohio,2,0,1,3,0.8333333333333333
2019-02-11,North Carolina,1,0,0,1,1.0
2019-02-11,South Carolina,0,1,0,1,0.0
2019-02-11,Minnesota,0,0,1,1,0.5
2019-02-11,Maine,0,0,2,2,0.5
2019-02-11,New Mexico,1,0,0,1,1.0
2019-02-11,North Dakota,0,0,1,1,0.5
2019-02-10,North Dakota,1,0,1,2,0.75
2019-02-10,Arizona,1,1,0,2,0.5
2019-02-10,Nevada,0,0,1,1,0.5
2019-02-10,Illinois,0,3,3,6,0.25
2019-02-10,Indiana,0,4,5,9,0.2777777777777778
2019-02-10,Utah,0,0,1,1,0.5
2019-02-10,California,8,2,5,15,0.7
2019-02-10,Arkansas,6,3,8,17,0.5882352941176471
2019-02-10,Kentucky,1,1,0,2,0.5
2019-02-10,Massachusetts,3,0,1,4,0.875
2019-02-10,Texas,1,0,2,3,0.6666666666666666
2019-02-10,New York,1,2,1,4,0.375
2019-02-10,Nebraska,1,0,0,1,1.0
2019-02-10,Colorado,1,3,1,5,0.30000000000000004
2019-02-10,Pennsylvania,1,0,1,2,0.75
2019-02-10,Minnesota,0,0,1,1,0.5
2019-02-10,Alabama,6,2,3,11,0.6818181818181818
2019-02-10,Michigan,0,1,0,1,0.0
2019-02-10,Ohio,2,0,0,2,1.0
2019-02-10,Georgia,1,1,2,4,0.5
2019-02-10,New Mexico,0,0,1,1,0.5
2019-02-10,Delaware,0,0,3,3,0.5
2019-02-10,Florida,0,3,1,4,0.125
2019-02-10,Iowa,0,0,1,1,0.5
2019-02-10,Oklahoma,0,1,0,1,0.0
2019-02-10,Hawaii,1,0,2,3,0.6666666666666666
2019-02-10,Louisiana,0,0,3,3,0.5
2019-02-10,New Jersey,0,1,0,1,0.0
2019-02-10,North Carolina,1,0,0,1,1.0
2019-02-10,Missouri,1,1,0,2,0.5
2019-02-10,Maryland,1,0,0,1,1.0
2019-02-09,Arkansas,1,2,1,4,0.375
2019-02-09,Washington,1,0,0,1,1.0
2019-02-09,Delaware,1,0,1,2,0.75
2019-02-09,Colorado,1,2,1,4,0.375
2019-02-09,Georgia,1,1,0,2,0.5
2019-02-09,Alabama,2,0,0,2,1.0
2019-02-09,Missouri,0,1,0,1,0.0
2019-02-09,Indiana,1,1,0,2,0.5
2019-02-09,California,1,0,1,2,0.75
2019-02-09,Oregon,0,0,1,1,0.5
2019-02-09,Florida,0,1,0,1,0.0
2019-02-09,Illinois,1,0,0,1,1.0
2019-02-09,Arizona,1,0,0,1,1.0
2019-02-09,Louisiana,1,0,0,1,1.0
2019-02-08,Georgia,1,0,0,1,1.0
2019-02-08,Nebraska,1,1,0,2,0.5
2019-02-08,Alabama,5,1,4,10,0.7
2019-02-08,Alaska,1,0,0,1,1.0
2019-02-08,California,4,3,1,8,0.5625
2019-02-08,Massachusetts,1,1,2,4,0.5
2019-02-08,New York,1,0,0,1,1.0
2019-02-08,Colorado,1,0,0,1,1.0
2019-02-08,Indiana,1,0,1,2,0.75
2019-02-08,Washington,1,0,0,1,1.0
2019-02-08,Arkansas,1,0,0,1,1.0
2019-02-08,Arizona,0,1,0,1,0.0
2019-02-07,Hawaii,8,1,0,9,0.8888888888888888
2019-02-07,Alabama,5,3,5,13,0.576923076923077
2019-02-07,Colorado,2,0,1,3,0.8333333333333333
2019-02-07,Arkansas,3,0,0,3,1.0
2019-02-07,Georgia,2,0,0,2,1.0
2019-02-07,Indiana,2,1,0,3,0.6666666666666666
2019-02-07,Minnesota,2,0,1,3,0.8333333333333333
2019-02-07,California,5,2,3,10,0.65
2019-02-07,New York,2,0,1,3,0.8333333333333333
2019-02-07,Massachusetts,2,0,2,4,0.75
2019-02-07,Illinois,0,1,1,2,0.25
2019-02-07,Nebraska,2,1,1,4,0.625
2019-02-07,Arizona,0,1,0,1,0.0
2019-02-07,Florida,1,0,0,1,1.0
2019-02-07,Delaware,0,1,0,1,0.0
2019-02-07,Connecticut,1,0,0,1,1.0
2019-02-07,Louisiana,1,0,0,1,1.0
2019-02-06,Massachusetts,4,3,1,8,0.5625
2019-02-06,Nebraska,1,0,0,1,1.0
2019-02-06,Alaska,0,1,0,1,0.0
2019-02-06,Florida,0,1,1,2,0.25
2019-02-06,California,1,1,1,3,0.5
2019-02-06,Washington,3,0,1,4,0.875
2019-02-06,Arkansas,1,0,0,1,1.0
2019-02-06,Georgia,1,0,0,1,1.0
2019-02-06,Louisiana,2,0,0,2,1.0
2019-02-06,Hawaii,7,1,0,8,0.875
2019-02-06,Kansas,1,0,0,1,1.0
2019-02-06,Arizona,1,1,0,2,0.5
2019-02-06,Connecticut,2,0,0,2,1.0
2019-02-06,Alabama,3,0,2,5,0.8
2019-02-06,Illinois,1,0,0,1,1.0
2019-02-06,Colorado,1,1,0,2,0.5
2019-02-06,New York,0,0,1,1,0.5
2019-02-06,Indiana,0,1,0,1,0.0
2019-02-05,Louisiana,1,0,0,1,1.0
2019-02-05,Missouri,1,1,1,3,0.5
2019-02-05,California,6,2,6,14,0.6428571428571428
2019-02-05,Massachusetts,3,1,0,4,0.75
2019-02-05,Hawaii,3,1,2,6,0.6666666666666666
2019-02-05,Connecticut,1,0,0,1,1.0
2019-02-05,Wisconsin,0,1,0,1,0.0
2019-02-05,Alabama,1,1,2,4,0.5
2019-02-05,Georgia,1,0,0,1,1.0
2019-02-05,Florida,1,1,2,4,0.5
2019-02-05,Delaware,2,0,0,2,1.0
2019-02-05,Washington,3,0,0,3,1.0
2019-02-05,Alaska,0,1,1,2,0.25
2019-02-05,Arkansas,1,1,2,4,0.5
2019-02-05,Minnesota,0,1,2,3,0.3333333333333333
2019-02-05,Colorado,1,0,0,1,1.0
2019-02-05,Nebraska,1,0,1,2,0.75
2019-02-05,Indiana,2,0,2,4,0.75
2019-02-05,Illinois,1,0,0,1,1.0
2019-02-04,Massachusetts,1,1,1,3,0.5
2019-02-04,Alabama,3,0,2,5,0.8
2019-02-04,Arkansas,1,0,1,2,0.75
2019-02-04,Hawaii,3,1,0,4,0.75
2019-02-04,New York,1,0,2,3,0.6666666666666666
2019-02-04,California,1,2,1,4,0.375
2019-02-04,Nebraska,1,0,0,1,1.0
2019-02-04,New Jersey,1,0,0,1,1.0
2019-02-04,Minnesota,1,0,0,1,1.0
2019-02-04,Iowa,0,1,0,1,0.0
2019-02-04,Arizona,0,1,0,1,0.0
2019-02-04,Colorado,0,1,0,1,0.0
2019-02-03,Indiana,1,0,1,2,0.75
2019-02-03,Alabama,1,0,2,3,0.6666666666666666
2019-02-03,Arizona,1,0,0,1,1.0
2019-02-03,Idaho,0,0,1,1,0.5
2019-02-03,Missouri,1,0,0,1,1.0
2019-02-03,Michigan,0,0,1,1,0.5
2019-02-03,New York,1,0,0,1,1.0
2019-02-03,Massachusetts,1,0,0,1,1.0
2019-02-03,California,1,1,1,3,0.5
2019-02-03,Colorado,0,0,1,1,0.5
2019-02-03,Illinois,1,0,0,1,1.0
2019-02-03,Virginia,0,0,1,1,0.5
2019-02-03,Nebraska,0,1,0,1,0.0
2019-02-03,Arkansas,1,0,0,1,1.0
2019-02-03,Alaska,0,0,1,1,0.5
2019-02-03,North Carolina,1,0,0,1,1.0
2019-02-02,Hawaii,0,1,0,1,0.0
2019-02-02,Alabama,2,0,1,3,0.8333333333333333
2019-02-02,California,5,0,1,6,0.9166666666666667
2019-02-02,Massachusetts,2,2,0,4,0.5
2019-02-02,Connecticut,1,1,0,2,0.5
2019-02-02,Minnesota,0,0,1,1,0.5
2019-02-02,Indiana,3,0,0,3,1.0
2019-02-02,Arkansas,1,0,0,1,1.0
2019-02-02,New York,1,0,0,1,1.0
2019-02-02,Maryland,0,1,0,1,0.0
2019-02-02,Arizona,1,0,0,1,1.0
2019-02-02,Washington,4,0,0,4,1.0
2019-02-02,Nebraska,1,0,0,1,1.0
2019-02-01,Indiana,2,0,0,2,1.0
2019-02-01,California,6,3,3,12,0.625
2019-02-01,Missouri,2,0,0,2,1.0
2019-02-01,Massachusetts,4,2,0,6,0.6666666666666666
2019-02-01,Delaware,1,0,0,1,1.0
2019-02-01,Texas,0,0,1,1,0.5
2019-02-01,Arizona,1,0,1,2,0.75
2019-02-01,Florida,2,0,1,3,0.8333333333333333
2019-02-01,Hawaii,0,0,2,2,0.5
2019-02-01,Arkansas,0,1,0,1,0.0
2019-02-01,Washington,0,1,0,1,0.0
2019-02-01,Illinois,1,0,0,1,1.0
2019-02-01,Iowa,1,0,0,1,1.0
2019-02-01,New Jersey,1,0,0,1,1.0
2019-02-01,Connecticut,1,0,0,1,1.0
2019-02-01,Pennsylvania,0,1,0,1,0.0
2019-02-01,Virginia,1,0,0,1,1.0
2019-02-01,Alabama,1,0,0,1,1.0
2019-02-01,Maryland,1,0,0,1,1.0
2019-01-31,New York,0,2,0,2,0.0
2019-01-31,Massachusetts,4,1,1,6,0.75
2019-01-31,Arkansas,0,0,1,1,0.5
2019-01-31,California,9,3,4,16,0.6875
2019-01-31,Alabama,1,0,1,2,0.75
2019-01-31,Hawaii,3,2,0,5,0.6
2019-01-31,Colorado,3,0,0,3,1.0
2019-01-31,Indiana,3,0,1,4,0.875
2019-01-31,Delaware,0,1,0,1,0.0
2019-01-31,Missouri,0,1,0,1,0.0
2019-01-31,Louisiana,0,0,1,1,0.5
2019-01-31,Nebraska,0,0,1,1,0.5
2019-01-31,Florida,2,0,1,3,0.8333333333333333
2019-01-31,Texas,1,0,0,1,1.0
2019-01-30,Massachusetts,5,1,0,6,0.8333333333333334
2019-01-30,California,4,4,7,15,0.5
2019-01-30,Arkansas,2,1,1,4,0.625
2019-01-30,Maryland,0,1,1,2,0.25
2019-01-30,Alabama,2,0,1,3,0.8333333333333333
2019-01-30,Hawaii,1,2,0,3,0.3333333333333333
2019-01-30,Connecticut,0,1,0,1,0.0
2019-01-30,Alaska,1,1,0,2,0.5
2019-01-30,Indiana,3,0,3,6,0.75
2019-01-30,Illinois,3,1,2,6,0.6666666666666666
2019-01-30,Florida,1,1,3,5,0.5
2019-01-30,Louisiana,1,0,2,3,0.6666666666666666
2019-01-30,Georgia,0,1,0,1,0.0
2019-01-30,Arizona,1,0,0,1,1.0
2019-01-30,Iowa,0,2,1,3,0.16666666666666666
2019-01-30,Colorado,1,0,0,1,1.0
2019-01-30,Wisconsin,0,1,0,1,0.0
2019-01-30,Texas,0,1,0,1,0.0
2019-01-30,New York,1,0,0,1,1.0
2019-01-30,Delaware,1,2,0,3,0.3333333333333333
2019-01-30,Kentucky,0,0,1,1,0.5
2019-01-30,Nebraska,1,0,0,1,1.0
2019-01-29,Alabama,5,1,4,10,0.7
2019-01-29,Virginia,0,1,0,1,0.0
2019-01-29,Michigan,0,1,0,1,0.0
2019-01-29,Florida,4,0,0,4,1.0
2019-01-29,California,7,3,4,14,0.6428571428571428
2019-01-29,New York,0,0,1,1,0.5
2019-01-29,Alaska,3,0,0,3,1.0
2019-01-29,New Jersey,1,0,0,1,1.0
2019-01-29,Massachusetts,7,1,1,9,0.8333333333333334
2019-01-29,Colorado,3,2,1,6,0.5833333333333334
2019-01-29,Arkansas,2,0,0,2,1.0
2019-01-29,Indiana,2,0,1,3,0.8333333333333333
2019-01-29,Delaware,0,2,1,3,0.16666666666666666
2019-01-29,Washington,1,0,1,2,0.75
2019-01-29,Illinois,2,1,1,4,0.625
2019-01-29,Georgia,0,0,1,1,0.5
2019-01-29,Maryland,0,1,0,1,0.0
2019-01-29,Connecticut,0,0,1,1,0.5
2019-01-29,Hawaii,4,1,0,5,0.8
2019-01-29,Oklahoma,1,0,0,1,1.0
2019-01-29,Arizona,1,0,0,1,1.0
2019-01-29,Nebraska,0,0,1,1,0.5
2019-01-29,Oregon,1,0,0,1,1.0
2019-01-29,Maine,1,0,0,1,1.0
2019-01-29,Kansas,0,1,0,1,0.0
2019-01-29,Idaho,0,1,0,1,0.0
2019-01-28,California,2,1,2,5,0.6000000000000001
2019-01-28,Arkansas,3,0,0,3,1.0
2019-01-28,Michigan,1,0,0,1,1.0
2019-01-28,Alabama,4,1,0,5,0.8
2019-01-28,Minnesota,0,0,1,1,0.5
2019-01-28,Nebraska,2,0,0,2,1.0
2019-01-28,Massachusetts,3,2,1,6,0.5833333333333334
2019-01-28,Louisiana,2,0,0,2,1.0
2019-01-28,Illinois,1,0,1,2,0.75
2019-01-28,Arizona,3,0,0,3,1.0
2019-01-28,Oklahoma,0,1,0,1,0.0
2019-01-28,Maryland,1,0,0,1,1.0
2019-01-28,Pennsylvania,1,0,0,1,1.0
2019-01-28,Washington,0,1,1,2,0.25
2019-01-28,Hawaii,5,0,1,6,0.9166666666666667
2019-01-28,Georgia,1,0,0,1,1.0
2019-01-28,Delaware,0,0,1,1,0.5
2019-01-28,Maine,0,0,1,1,0.5
2019-01-28,Colorado,0,1,1,2,0.25
2019-01-28,Indiana,1,0,0,1,1.0
2019-01-28,Florida,1,0,0,1,1.0
2019-01-27,California,2,0,1,3,0.8333333333333333
2019-01-27,Colorado,1,1,0,2,0.5
2019-01-27,Arkansas,1,0,1,2,0.75
2019-01-27,Hawaii,0,0,1,1,0.5
2019-01-27,Massachusetts,1,1,0,2,0.5
2019-01-27,Indiana,3,0,0,3,1.0
2019-01-27,Alaska,1,0,0,1,1.0
2019-01-27,Illinois,0,1,0,1,0.0
2019-01-27,Alabama,1,1,0,2,0.5
2019-01-27,Arizona,1,0,0,1,1.0
2019-01-27,Nebraska,1,0,0,1,1.0
2019-01-27,Missouri,1,0,0,1,1.0
2019-01-26,Nebraska,0,1,0,1,0.0
2019-01-26,Georgia,1,0,1,2,0.75
2019-01-26,Indiana,2,0,0,2,1.0
2019-01-26,Arizona,4,0,0,4,1.0
2019-01-26,Alaska,0,1,0,1,0.0
2019-01-26,Illinois,0,1,1,2,0.25
2019-01-26,Alabama,2,0,1,3,0.8333333333333333
2019-01-26,California,3,1,0,4,0.75
2019-01-26,Arkansas,2,0,0,2,1.0
2019-01-26,Massachusetts,0,1,2,3,0.3333333333333333
2019-01-26,Virginia,1,0,0,1,1.0
2019-01-26,Louisiana,1,0,0,1,1.0
2019-01-25,Massachusetts,4,2,1,7,0.6428571428571428
2019-01-25,Illinois,0,1,0,1,0.0
2019-01-25,Hawaii,0,0,1,1,0.5
2019-01-25,Arkansas,1,0,0,1,1.0
2019-01-25,Texas,2,0,0,2,1.0
2019-01-25,Florida,0,1,0,1,0.0
2019-01-25,California,1,0,0,1,1.0
2019-01-25,Arizona,1,0,0,1,1.0
2019-01-25,Alabama,1,0,0,1,1.0
2019-01-25,Nebraska,0,0,1,1,0.5
2019-01-25,Colorado,0,0,1,1,0.5
2019-01-25,Washington,0,0,1,1,0.5
2019-01-25,Louisiana,1,0,0,1,1.0
2019-01-25,Missouri,3,0,0,3,1.0
2019-01-25,Connecticut,0,0,1,1,0.5
2019-01-24,Illinois,2,1,0,3,0.6666666666666666
2019-01-24,Nebraska,1,0,0,1,1.0
2019-01-24,Massachusetts,5,1,1,7,0.7857142857142857
2019-01-24,New York,1,0,0,1,1.0
2019-01-24,Louisiana,2,0,0,2,1.0
2019-01-24,Washington,1,1,0,2,0.5
2019-01-24,Hawaii,1,0,0,1,1.0
2019-01-24,Maryland,1,0,0,1,1.0
2019-01-24,California,1,0,0,1,1.0
2019-01-24,Colorado,4,0,1,5,0.9
2019-01-24,Alabama,0,0,2,2,0.5
2019-01-24,Indiana,0,0,1,1,0.5
2019-01-24,Arizona,1,1,0,2,0.5
2019-01-24,Florida,0,1,0,1,0.0
2019-01-24,Missouri,1,0,0,1,1.0
2019-01-24,Georgia,0,1,0,1,0.0
2019-01-23,New Jersey,1,0,0,1,1.0
2019-01-23,Alabama,0,0,2,2,0.5
2019-01-23,Massachusetts,4,0,2,6,0.8333333333333333
2019-01-23,Louisiana,1,0,1,2,0.75
2019-01-23,Idaho,1,0,0,1,1.0
2019-01-23,Maryland,0,0,1,1,0.5
2019-01-23,Illinois,1,1,0,2,0.5
2019-01-23,Indiana,1,1,2,4,0.5
2019-01-23,Florida,3,0,0,3,1.0
2019-01-23,Arkansas,2,0,0,2,1.0
2019-01-23,Georgia,2,0,0,2,1.0
2019-01-23,Oregon,1,0,0,1,1.0
2019-01-23,California,1,1,0,2,0.5
2019-01-23,Texas,1,0,0,1,1.0
2019-01-22,Arkansas,2,0,1,3,0.8333333333333333
2019-01-22,California,1,1,1,3,0.5
2019-01-22,Minnesota,1,0,0,1,1.0
2019-01-22,Colorado,1,1,0,2,0.5
2019-01-22,Hawaii,0,1,0,1,0.0
2019-01-22,Indiana,1,1,0,2,0.5
2019-01-22,Missouri,0,0,1,1,0.5
2019-01-22,Alabama,2,0,1,3,0.8333333333333333
2019-01-22,Nebraska,1,1,0,2,0.5
2019-01-22,Massachusetts,1,0,0,1,1.0
2019-01-22,New Jersey,1,0,0,1,1.0
2019-01-22,Maryland,1,0,0,1,1.0
2019-01-21,Maryland,1,0,0,1,1.0
2019-01-21,Arizona,1,0,1,2,0.75
2019-01-21,Florida,4,0,0,4,1.0
2019-01-21,Alabama,3,0,2,5,0.8
2019-01-21,Indiana,0,2,1,3,0.16666666666666666
2019-01-21,Louisiana,1,0,0,1,1.0
2019-01-21,Missouri,1,0,0,1,1.0
2019-01-21,New York,0,0,1,1,0.5
2019-01-21,Alaska,0,0,1,1,0.5
2019-01-21,Georgia,1,0,0,1,1.0
2019-01-21,Nebraska,1,0,0,1,1.0
2019-01-21,Colorado,1,0,0,1,1.0
2019-01-21,Illinois,0,1,2,3,0.3333333333333333
2019-01-21,California,1,0,1,2,0.75
2019-01-20,California,3,1,0,4,0.75
2019-01-20,Alabama,2,0,0,2,1.0
2019-01-20,Massachusetts,3,2,2,7,0.5714285714285714
2019-01-20,Florida,1,0,0,1,1.0
2019-01-20,Indiana,1,0,2,3,0.6666666666666666
2019-01-20,Arizona,2,0,0,2,1.0
2019-01-20,Alaska,0,0,1,1,0.5
2019-01-20,New York,0,0,1,1,0.5
2019-01-20,Colorado,2,0,0,2,1.0
2019-01-20,Hawaii,0,0,1,1,0.5
2019-01-20,Nebraska,1,0,0,1,1.0
2019-01-19,Hawaii,1,0,0,1,1.0
2019-01-19,Massachusetts,0,0,1,1,0.5
2019-01-19,Oregon,1,0,0,1,1.0
2019-01-19,Missouri,2,0,0,2,1.0
2019-01-19,Colorado,1,0,0,1,1.0
2019-01-19,Maine,1,0,0,1,1.0
2019-01-19,Florida,1,0,0,1,1.0
2019-01-19,Alaska,0,0,1,1,0.5
2019-01-19,California,0,2,0,2,0.0
2019-01-19,Alabama,2,0,0,2,1.0
2019-01-19,Nebraska,1,0,0,1,1.0
2019-01-19,Arizona,1,0,0,1,1.0
2019-01-18,Massachusetts,2,1,0,3,0.6666666666666666
2019-01-18,Georgia,0,1,0,1,0.0
2019-01-18,Indiana,3,0,1,4,0.875
2019-01-18,California,1,1,1,3,0.5
2019-01-18,Alabama,1,0,3,4,0.625
2019-01-18,Iowa,2,0,2,4,0.75
2019-01-18,Illinois,0,0,1,1,0.5
2019-01-18,Arkansas,1,0,1,2,0.75
2019-01-18,Hawaii,0,2,0,2,0.0
2019-01-18,New York,1,0,0,1,1.0
2019-01-18,Kansas,0,1,0,1,0.0
2019-01-18,Florida,2,0,0,2,1.0
2019-01-17,Indiana,0,1,0,1,0.0
2019-01-17,Massachusetts,4,2,1,7,0.6428571428571428
2019-01-17,Hawaii,3,0,0,3,1.0
2019-01-17,Missouri,1,0,0,1,1.0
2019-01-17,Arkansas,1,0,1,2,0.75
2019-01-17,Washington,1,0,0,1,1.0
2019-01-17,California,7,2,1,10,0.75
2019-01-17,Alaska,1,1,0,2,0.5
2019-01-17,Nebraska,1,0,1,2,0.75
2019-01-17,Georgia,0,1,0,1,0.0
2019-01-17,Alabama,1,0,0,1,1.0
2019-01-17,Kansas,1,0,0,1,1.0
2019-01-16,Massachusetts,4,0,1,5,0.9
2019-01-16,Indiana,3,0,0,3,1.0
2019-01-16,New York,1,1,0,2,0.5
2019-01-16,Florida,1,0,0,1,1.0
2019-01-16,Maryland,1,0,0,1,1.0
2019-01-16,Nebraska,2,1,0,3,0.6666666666666666
2019-01-16,Delaware,0,0,1,1,0.5
2019-01-16,North Carolina,1,0,0,1,1.0
2019-01-16,Colorado,0,1,0,1,0.0
2019-01-16,Hawaii,1,0,0,1,1.0
2019-01-16,Alabama,1,0,0,1,1.0
2019-01-16,Arizona,1,0,1,2,0.75
2019-01-15,Washington,1,0,0,1,1.0
2019-01-15,California,2,1,2,5,0.6000000000000001
2019-01-15,Minnesota,0,0,2,2,0.5
2019-01-15,Arizona,2,0,0,2,1.0
2019-01-15,Alabama,1,0,2,3,0.6666666666666666
2019-01-15,Florida,0,1,0,1,0.0
2019-01-15,Indiana,2,0,0,2,1.0
2019-01-15,Nebraska,0,1,0,1,0.0
2019-01-15,Rhode Island,1,0,0,1,1.0
2019-01-15,Illinois,1,0,0,1,1.0
2019-01-15,Massachusetts,0,0,1,1,0.5
2019-01-15,Georgia,1,0,0,1,1.0
2019-01-15,Kansas,1,0,0,1,1.0
2019-01-14,California,0,1,3,4,0.375
2019-01-14,Florida,5,0,0,5,1.0
2019-01-14,Illinois,1,0,0,1,1.0
2019-01-14,Massachusetts,0,0,1,1,0.5
2019-01-14,Iowa,1,0,0,1,1.0
2019-01-14,Alabama,2,0,0,2,1.0
2019-01-14,Oregon,1,0,0,1,1.0
2019-01-14,New York,0,1,1,2,0.25
2019-01-14,Delaware,2,0,1,3,0.8333333333333333
2019-01-14,Hawaii,1,0,0,1,1.0
2019-01-14,Indiana,0,1,0,1,0.0
2019-01-13,Florida,1,0,0,1,1.0
2019-01-13,Alabama,2,0,0,2,1.0
2019-01-13,California,2,0,2,4,0.75
2019-01-13,Colorado,1,0,0,1,1.0
2019-01-13,Indiana,1,1,0,2,0.5
2019-01-13,Massachusetts,0,1,0,1,0.0
2019-01-13,Delaware,1,0,1,2,0.75
2019-01-13,Nebraska,2,0,0,2,1.0
2019-01-13,Iowa,0,1,0,1,0.0
2019-01-13,New York,0,1,0,1,0.0
2019-01-12,Kentucky,1,1,0,2,0.5
2019-01-12,Georgia,0,0,1,1,0.5
2019-01-12,Alabama,3,0,1,4,0.875
2019-01-12,New York,1,0,1,2,0.75
2019-01-12,California,1,0,1,2,0.75
2019-01-12,Louisiana,1,0,1,2,0.75
2019-01-12,Massachusetts,0,0,2,2,0.5
2019-01-12,Oregon,1,0,0,1,1.0
2019-01-12,Colorado,1,0,0,1,1.0
2019-01-12,Hawaii,1,1,0,2,0.5
2019-01-12,Indiana,1,0,0,1,1.0
2019-01-12,Maryland,0,1,0,1,0.0
2019-01-11,Indiana,1,0,1,2,0.75
2019-01-11,Colorado,1,1,0,2,0.5
2019-01-11,Washington,1,0,0,1,1.0
2019-01-11,Minnesota,0,0,1,1,0.5
2019-01-11,California,3,1,0,4,0.75
2019-01-11,Arizona,0,1,0,1,0.0
2019-01-11,Alabama,0,0,1,1,0.5
2019-01-11,Michigan,1,0,0,1,1.0
2019-01-11,Hawaii,1,0,0,1,1.0
2019-01-11,Arkansas,2,0,0,2,1.0
2019-01-11,Delaware,1,0,0,1,1.0
2019-01-11,Massachusetts,2,0,0,2,1.0
2019-01-11,Florida,1,1,0,2,0.5
2019-01-11,Iowa,0,1,0,1,0.0
2019-01-11,Nebraska,1,0,1,2,0.75
2019-01-11,Alaska,0,1,0,1,0.0
2019-01-10,Maryland,2,0,0,2,1.0
2019-01-10,Texas,0,1,1,2,0.25
2019-01-10,Nebraska,0,0,1,1,0.5
2019-01-10,Delaware,1,0,0,1,1.0
2019-01-10,Arkansas,1,0,0,1,1.0
2019-01-10,Washington,1,0,0,1,1.0
2019-01-10,Missouri,1,0,0,1,1.0
2019-01-10,Massachusetts,3,0,2,5,0.8
2019-01-10,Hawaii,2,0,0,2,1.0
2019-01-10,Colorado,1,0,1,2,0.75
2019-01-10,Illinois,1,0,0,1,1.0
2019-01-10,Florida,0,0,1,1,0.5
2019-01-10,Alabama,1,2,0,3,0.3333333333333333
2019-01-10,Arizona,1,0,0,1,1.0
2019-01-10,California,0,1,0,1,0.0
2019-01-10,New York,1,0,0,1,1.0
2019-01-09,Hawaii,3,1,0,4,0.75
2019-01-09,Alabama,7,0,0,7,1.0
2019-01-09,Arkansas,2,0,1,3,0.8333333333333333
2019-01-09,Indiana,4,0,0,4,1.0
2019-01-09,Illinois,0,1,1,2,0.25
2019-01-09,Georgia,1,0,1,2,0.75
2019-01-09,Minnesota,1,0,0,1,1.0
2019-01-09,Washington,2,0,0,2,1.0
2019-01-09,Louisiana,1,0,0,1,1.0
2019-01-09,California,2,0,0,2,1.0
2019-01-09,Florida,0,2,0,2,0.0
2019-01-09,Alaska,1,0,0,1,1.0
2019-01-09,Iowa,1,0,0,1,1.0
2019-01-09,Massachusetts,1,0,0,1,1.0
2019-01-08,Georgia,1,0,0,1,1.0
2019-01-08,Colorado,1,0,0,1,1.0
2019-01-08,Alabama,4,0,0,4,1.0
2019-01-08,Massachusetts,1,0,0,1,1.0
2019-01-08,Missouri,2,0,0,2,1.0
2019-01-08,Arizona,0,0,1,1,0.5
2019-01-08,Hawaii,1,0,0,1,1.0
2019-01-08,Indiana,1,0,0,1,1.0
2019-01-08,Florida,3,1,0,4,0.75
2019-01-08,California,2,0,0,2,1.0
2019-01-08,Maryland,1,0,0,1,1.0
2019-01-08,Arkansas,2,0,0,2,1.0
2019-01-08,Louisiana,0,0,1,1,0.5
2019-01-08,Pennsylvania,1,0,0,1,1.0
2019-01-08,Illinois,0,0,1,1,0.5
2019-01-08,Oregon,1,0,0,1,1.0
2019-01-07,Alabama,2,2,2,6,0.5
2019-01-07,Delaware,0,1,1,2,0.25
2019-01-07,California,5,0,1,6,0.9166666666666667
2019-01-07,Kentucky,0,0,1,1,0.5
2019-01-07,Massachusetts,2,0,1,3,0.8333333333333333
2019-01-07,Florida,0,0,1,1,0.5
2019-01-07,Arizona,0,1,0,1,0.0
2019-01-07,Indiana,0,0,1,1,0.5
2019-01-07,Maryland,0,1,0,1,0.0
2019-01-07,Alaska,1,0,0,1,1.0
2019-01-06,Nebraska,1,0,0,1,1.0
2019-01-06,Alabama,3,0,1,4,0.875
2019-01-06,Alaska,0,1,1,2,0.25
2019-01-06,Pennsylvania,1,0,0,1,1.0
2019-01-06,Hawaii,1,0,0,1,1.0
2019-01-06,California,0,3,0,3,0.0
2019-01-06,Michigan,0,0,1,1,0.5
2019-01-06,Louisiana,0,0,1,1,0.5
2019-01-06,Indiana,1,0,0,1,1.0
2019-01-06,Arkansas,0,1,0,1,0.0
2019-01-06,Oregon,0,1,0,1,0.0
2019-01-06,Colorado,1,0,0,1,1.0
2019-01-06,Washington,3,0,0,3,1.0
2019-01-05,Arkansas,1,0,0,1,1.0
2019-01-05,California,4,0,1,5,0.9
2019-01-05,Iowa,0,1,0,1,0.0
2019-01-05,Indiana,0,0,1,1,0.5
2019-01-05,Nebraska,0,0,1,1,0.5
2019-01-05,Alabama,1,0,0,1,1.0
2019-01-05,Colorado,2,0,1,3,0.8333333333333333
2019-01-05,Massachusetts,0,0,1,1,0.5
2019-01-05,Florida,1,0,0,1,1.0
2019-01-05,Maine,2,0,0,2,1.0
2019-01-04,Alabama,3,1,1,5,0.7
2019-01-04,California,2,0,2,4,0.75
2019-01-04,Kentucky,1,0,0,1,1.0
2019-01-04,New York,1,0,0,1,1.0
2019-01-04,Iowa,1,0,2,3,0.6666666666666666
2019-01-04,Hawaii,0,0,1,1,0.5
2019-01-04,Florida,1,0,0,1,1.0
2019-01-04,Georgia,1,0,0,1,1.0
2019-01-04,Arkansas,2,0,0,2,1.0
2019-01-04,Indiana,1,0,0,1,1.0
2019-01-04,Connecticut,1,0,0,1,1.0
2019-01-04,Massachusetts,0,1,0,1,0.0
2019-01-03,California,2,0,0,2,1.0
2019-01-03,Nebraska,1,0,1,2,0.75
2019-01-03,Arkansas,1,0,0,1,1.0
2019-01-03,Colorado,2,1,0,3,0.6666666666666666
2019-01-03,Massachusetts,1,0,0,1,1.0
2019-01-03,North Carolina,0,0,1,1,0.5
2019-01-03,Hawaii,3,0,0,3,1.0
2019-01-03,New York,1,0,0,1,1.0
2019-01-03,Indiana,2,1,0,3,0.6666666666666666
2019-01-03,Minnesota,1,0,0,1,1.0
2019-01-03,Florida,1,0,0,1,1.0
2019-01-03,Alabama,0,1,0,1,0.0
2019-01-03,Georgia,1,0,0,1,1.0
2019-01-02,California,5,0,0,5,1.0
2019-01-02,Arizona,1,0,0,1,1.0
2019-01-02,Connecticut,1,0,0,1,1.0
2019-01-02,Iowa,0,2,0,2,0.0
2019-01-02,Indiana,1,0,0,1,1.0
2019-01-02,Nebraska,0,0,1,1,0.5
2019-01-02,Florida,1,1,0,2,0.5
2019-01-02,Maryland,2,0,0,2,1.0
2019-01-02,Georgia,1,0,0,1,1.0
2019-01-02,Arkansas,1,0,0,1,1.0
2019-01-02,Alabama,0,0,1,1,0.5
2019-01-02,Delaware,1,0,1,2,0.75
2019-01-02,Oregon,0,1,0,1,0.0
2019-01-02,Massachusetts,1,0,0,1,1.0
2019-01-01,Colorado,1,1,0,2,0.5
2019-01-01,California,2,1,1,4,0.625
2019-01-01,Iowa,0,1,0,1,0.0
2019-01-01,New York,2,0,0,2,1.0
2019-01-01,Alabama,1,0,0,1,1.0
2019-01-01,Indiana,1,0,1,2,0.75
2019-01-01,Arizona,1,0,0,1,1.0
2019-01-01,Massachusetts,0,1,1,2,0.25
2019-01-01,Hawaii,0,0,1,1,0.5
2018-12-31,California,5,0,1,6,0.9166666666666667
2018-12-31,Missouri,1,0,1,2,0.75
2018-12-31,Arizona,1,1,0,2,0.5
2018-12-31,Georgia,1,2,0,3,0.3333333333333333
2018-12-31,Maine,2,0,0,2,1.0
2018-12-31,Arkansas,1,0,0,1,1.0
2018-12-31,Indiana,3,1,0,4,0.75
2018-12-31,Alabama,5,0,0,5,1.0
2018-12-31,New Hampshire,1,0,0,1,1.0
2018-12-31,Hawaii,0,0,1,1,0.5
2018-12-31,Alaska,0,1,0,1,0.0
2018-12-30,California,5,3,2,10,0.6
2018-12-30,Florida,0,0,1,1,0.5
2018-12-30,Alabama,3,0,1,4,0.875
2018-12-30,North Carolina,2,0,0,2,1.0
2018-12-30,Delaware,2,0,0,2,1.0
2018-12-30,Missouri,0,1,1,2,0.25
2018-12-30,New York,12,3,2,17,0.7647058823529412
2018-12-30,Arkansas,0,0,2,2,0.5
2018-12-30,New Mexico,1,0,0,1,1.0
2018-12-30,Hawaii,1,0,0,1,1.0
2018-12-30,Massachusetts,1,0,0,1,1.0
2018-12-30,Washington,2,0,0,2,1.0
2018-12-30,Georgia,1,0,0,1,1.0
2018-12-30,Colorado,1,1,0,2,0.5
2018-12-30,Maryland,1,0,0,1,1.0
2018-12-29,California,0,3,0,3,0.0
2018-12-29,Massachusetts,2,0,0,2,1.0
2018-12-29,Illinois,1,0,1,2,0.75
2018-12-29,Hawaii,2,0,1,3,0.8333333333333333
2018-12-29,Indiana,3,1,0,4,0.75
2018-12-29,Texas,0,0,1,1,0.5
2018-12-29,Maryland,0,0,1,1,0.5
2018-12-29,Alabama,0,0,1,1,0.5
2018-12-29,Kansas,1,0,0,1,1.0
2018-12-29,Missouri,0,1,0,1,0.0
2018-12-29,Florida,1,0,0,1,1.0
2018-12-29,Oregon,1,0,1,2,0.75
2018-12-28,California,2,0,1,3,0.8333333333333333
2018-12-28,Hawaii,3,0,2,5,0.8
2018-12-28,Indiana,3,0,0,3,1.0
2018-12-28,Alabama,2,0,0,2,1.0
2018-12-28,Alaska,1,0,0,1,1.0
2018-12-28,Louisiana,1,0,0,1,1.0
2018-12-28,Florida,0,0,1,1,0.5
2018-12-28,Georgia,1,0,0,1,1.0
2018-12-28,Iowa,1,1,0,2,0.5
2018-12-28,Arkansas,1,0,0,1,1.0
2018-12-28,Nebraska,1,0,0,1,1.0
2018-12-27,California,1,1,0,2,0.5
2018-12-27,Massachusetts,1,0,0,1,1.0
2018-12-27,Missouri,0,0,1,1,0.5
2018-12-27,Indiana,1,1,0,2,0.5
2018-12-27,Alabama,1,0,1,2,0.75
2018-12-27,Florida,1,0,0,1,1.0
2018-12-27,Georgia,1,0,0,1,1.0
2018-12-27,Arkansas,0,0,1,1,0.5
2018-12-27,Maine,1,0,0,1,1.0
2018-12-27,Hawaii,0,0,1,1,0.5
2018-12-26,California,2,0,0,2,1.0
2018-12-26,Washington,3,0,0,3,1.0
2018-12-26,Alabama,6,0,0,6,1.0
2018-12-26,Massachusetts,1,0,0,1,1.0
2018-12-26,Hawaii,1,0,0,1,1.0
2018-12-26,Maine,1,0,0,1,1.0
2018-12-26,Maryland,0,0,1,1,0.5
2018-12-26,Indiana,1,0,0,1,1.0
2018-12-26,Georgia,1,0,0,1,1.0
2018-12-26,Iowa,0,0,1,1,0.5
2018-12-25,Washington,0,0,1,1,0.5
2018-12-25,Oregon,0,1,0,1,0.0
2018-12-25,Missouri,1,0,0,1,1.0
2018-12-25,Florida,0,0,1,1,0.5
2018-12-25,Iowa,1,0,0,1,1.0
2018-12-25,New York,1,1,0,2,0.5
2018-12-25,Delaware,1,0,0,1,1.0
2018-12-25,California,1,0,0,1,1.0
2018-12-24,Kentucky,1,0,0,1,1.0
2018-12-24,Massachusetts,2,0,0,2,1.0
2018-12-24,Colorado,1,0,0,1,1.0
2018-12-24,Arkansas,0,0,1,1,0.5
2018-12-24,Alaska,0,0,1,1,0.5
2018-12-24,Arizona,0,0,1,1,0.5
2018-12-24,Indiana,1,0,0,1,1.0
2018-12-24,Alabama,1,0,0,1,1.0
2018-12-23,Massachusetts,1,0,1,2,0.75
2018-12-23,Colorado,0,1,0,1,0.0
2018-12-23,Alabama,1,0,0,1,1.0
2018-12-23,Florida,1,0,0,1,1.0
2018-12-23,Indiana,2,0,0,2,1.0
2018-12-23,Illinois,1,0,0,1,1.0
2018-12-23,Arizona,0,1,0,1,0.0
2018-12-23,Hawaii,0,0,1,1,0.5
2018-12-22,Colorado,1,0,0,1,1.0
2018-12-22,Alabama,1,1,0,2,0.5
2018-12-22,California,2,1,0,3,0.6666666666666666
2018-12-22,Illinois,0,1,0,1,0.0
2018-12-22,Virginia,2,0,0,2,1.0
2018-12-22,New York,1,0,0,1,1.0
2018-12-22,Indiana,1,1,0,2,0.5
2018-12-22,Arkansas,1,0,0,1,1.0
2018-12-22,Arizona,1,0,0,1,1.0
2018-12-22,Washington,0,0,1,1,0.5
2018-12-21,Indiana,4,0,1,5,0.9
2018-12-21,California,3,0,0,3,1.0
2018-12-21,Massachusetts,0,1,0,1,0.0
2018-12-21,Delaware,1,1,0,2,0.5
2018-12-21,Maryland,0,0,1,1,0.5
2018-12-21,Alabama,1,0,0,1,1.0
2018-12-21,Louisiana,1,0,0,1,1.0
2018-12-21,Hawaii,1,0,0,1,1.0
2018-12-21,Arkansas,0,1,0,1,0.0
2018-12-21,Georgia,0,1,0,1,0.0
2018-12-21,Iowa,1,1,0,2,0.5
2018-12-21,Missouri,1,0,0,1,1.0
2018-12-21,Washington,0,0,1,1,0.5
2018-12-20,Indiana,4,0,0,4,1.0
2018-12-20,California,1,0,2,3,0.6666666666666666
2018-12-20,Kansas,0,0,1,1,0.5
2018-12-20,Alabama,1,0,1,2,0.75
2018-12-20,Oregon,0,1,0,1,0.0
2018-12-20,Louisiana,0,0,1,1,0.5
2018-12-20,Colorado,1,0,0,1,1.0
2018-12-20,Hawaii,1,0,1,2,0.75
2018-12-20,Nebraska,2,0,0,2,1.0
2018-12-20,Missouri,0,1,0,1,0.0
2018-12-20,Massachusetts,1,0,0,1,1.0
2018-12-20,Georgia,1,0,0,1,1.0
2018-12-20,Washington,1,0,0,1,1.0
2018-12-20,Connecticut,0,0,1,1,0.5
2018-12-20,Arizona,3,0,0,3,1.0
2018-12-19,Indiana,6,0,0,6,1.0
2018-12-19,Massachusetts,2,0,0,2,1.0
2018-12-19,Missouri,0,1,0,1,0.0
2018-12-19,Iowa,0,1,0,1,0.0
2018-12-19,Louisiana,1,2,0,3,0.3333333333333333
2018-12-19,California,1,1,0,2,0.5
2018-12-19,Alabama,2,0,2,4,0.75
2018-12-19,Illinois,1,0,0,1,1.0
2018-12-19,Florida,2,1,0,3,0.6666666666666666
2018-12-19,Colorado,1,0,0,1,1.0
2018-12-19,Wisconsin,1,0,0,1,1.0
2018-12-19,New York,1,0,0,1,1.0
2018-12-18,Texas,2,0,0,2,1.0
2018-12-18,Indiana,2,0,0,2,1.0
2018-12-18,Hawaii,4,0,1,5,0.9
2018-12-18,Louisiana,0,0,1,1,0.5
2018-12-18,Virginia,1,0,0,1,1.0
2018-12-18,Massachusetts,3,0,0,3,1.0
2018-12-18,Alabama,4,1,2,7,0.7142857142857142
2018-12-18,Washington,2,0,0,2,1.0
2018-12-18,Arizona,1,0,0,1,1.0
2018-12-18,California,1,2,1,4,0.375
2018-12-18,Florida,3,1,0,4,0.75
2018-12-18,Arkansas,0,0,1,1,0.5
2018-12-17,Alabama,4,0,1,5,0.9
2018-12-17,Oklahoma,0,0,1,1,0.5
2018-12-17,Arkansas,0,0,1,1,0.5
2018-12-17,Indiana,1,0,0,1,1.0
2018-12-17,Georgia,0,0,2,2,0.5
2018-12-17,Hawaii,2,0,1,3,0.8333333333333333
2018-12-17,Missouri,0,0,1,1,0.5
2018-12-17,California,2,0,1,3,0.8333333333333333
2018-12-17,Kentucky,1,0,0,1,1.0
2018-12-17,New York,1,0,0,1,1.0
2018-12-17,Maryland,1,0,0,1,1.0
2018-12-16,Georgia,0,0,1,1,0.5
2018-12-16,Missouri,2,0,0,2,1.0
2018-12-16,Arizona,1,0,0,1,1.0
2018-12-16,Alaska,1,0,0,1,1.0
2018-12-16,Nebraska,0,1,0,1,0.0
2018-12-16,Illinois,1,0,0,1,1.0
2018-12-16,Rhode Island,1,0,0,1,1.0
2018-12-16,Colorado,1,0,0,1,1.0
2018-12-16,Washington,1,0,0,1,1.0
2018-12-16,New York,0,0,1,1,0.5
2018-12-16,Massachusetts,2,0,0,2,1.0
2018-12-16,California,1,0,0,1,1.0
2018-12-16,Oregon,1,0,0,1,1.0
2018-12-16,Maine,1,0,0,1,1.0
2018-12-16,Louisiana,0,0,1,1,0.5
2018-12-16,Florida,1,0,0,1,1.0
2018-12-16,Indiana,2,1,0,3,0.6666666666666666
2018-12-15,Indiana,3,0,0,3,1.0
2018-12-15,Missouri,1,0,0,1,1.0
2018-12-15,Hawaii,1,0,1,2,0.75
2018-12-15,Georgia,0,1,0,1,0.0
2018-12-15,Massachusetts,2,0,1,3,0.8333333333333333
2018-12-15,California,1,0,1,2,0.75
2018-12-15,New York,1,0,2,3,0.6666666666666666
2018-12-15,Alabama,1,1,0,2,0.5
2018-12-15,Connecticut,1,0,0,1,1.0
2018-12-15,Florida,1,2,0,3,0.3333333333333333
2018-12-14,Alabama,4,0,0,4,1.0
2018-12-14,Georgia,0,1,0,1,0.0
2018-12-14,Indiana,1,0,1,2,0.75
2018-12-14,Massachusetts,0,0,2,2,0.5
2018-12-14,Michigan,0,1,0,1,0.0
2018-12-14,Delaware,0,0,1,1,0.5
2018-12-14,California,1,1,1,3,0.5
2018-12-14,Hawaii,0,1,0,1,0.0
2018-12-14,New Jersey,1,0,0,1,1.0
2018-12-14,Washington,2,0,0,2,1.0
2018-12-14,Ohio,1,0,0,1,1.0
2018-12-14,Kansas,0,1,0,1,0.0
2018-12-13,California,3,1,5,9,0.6111111111111112
2018-12-13,Hawaii,2,0,0,2,1.0
2018-12-13,Massachusetts,3,0,1,4,0.875
2018-12-13,Washington,0,0,1,1,0.5
2018-12-13,Alabama,2,0,1,3,0.8333333333333333
2018-12-13,Alaska,1,0,0,1,1.0
2018-12-13,Arkansas,0,0,2,2,0.5
2018-12-13,Florida,2,0,0,2,1.0
2018-12-12,Arizona,2,0,0,2,1.0
2018-12-12,Indiana,2,0,0,2,1.0
2018-12-12,Georgia,3,0,0,3,1.0
2018-12-12,Hawaii,2,0,0,2,1.0
2018-12-12,Missouri,0,1,0,1,0.0
2018-12-12,New York,0,1,0,1,0.0
2018-12-12,Colorado,0,1,0,1,0.0
2018-12-12,California,3,0,2,5,0.8
2018-12-12,New Jersey,0,0,1,1,0.5
2018-12-12,Alaska,1,0,0,1,1.0
2018-12-12,Pennsylvania,1,0,1,2,0.75
2018-12-12,Oregon,0,0,1,1,0.5
2018-12-12,Virginia,1,0,0,1,1.0
2018-12-12,Massachusetts,1,0,1,2,0.75
2018-12-12,Alabama,2,0,0,2,1.0
2018-12-12,Florida,1,0,0,1,1.0
2018-12-12,Arkansas,1,0,0,1,1.0
2018-12-11,Iowa,0,1,0,1,0.0
2018-12-11,California,5,2,3,10,0.65
2018-12-11,Alabama,3,0,1,4,0.875
2018-12-11,Colorado,0,1,0,1,0.0
2018-12-11,Washington,1,0,0,1,1.0
2018-12-11,Minnesota,1,0,0,1,1.0
2018-12-11,Hawaii,3,1,1,5,0.7
2018-12-11,Nebraska,2,1,0,3,0.6666666666666666
2018-12-11,Massachusetts,5,1,0,6,0.8333333333333334
2018-12-11,Georgia,1,0,1,2,0.75
2018-12-11,Louisiana,2,0,0,2,1.0
2018-12-11,Indiana,3,0,3,6,0.75
2018-12-11,Arkansas,0,0,1,1,0.5
2018-12-11,Illinois,1,0,1,2,0.75
2018-12-11,New Jersey,2,0,0,2,1.0
2018-12-11,Kansas,1,0,0,1,1.0
2018-12-11,Michigan,0,1,2,3,0.3333333333333333
2018-12-11,Pennsylvania,1,0,0,1,1.0
2018-12-11,Alaska,1,0,0,1,1.0
2018-12-10,Indiana,2,0,0,2,1.0
2018-12-10,Arkansas,1,0,1,2,0.75
2018-12-10,Alaska,0,0,1,1,0.5
2018-12-10,Alabama,2,1,0,3,0.6666666666666666
2018-12-10,Oregon,1,0,0,1,1.0
2018-12-10,Missouri,0,1,0,1,0.0
2018-12-10,California,1,0,2,3,0.6666666666666666
2018-12-10,Massachusetts,2,0,3,5,0.7
2018-12-10,Hawaii,1,0,1,2,0.75
2018-12-10,Washington,1,0,0,1,1.0
2018-12-10,Colorado,1,0,0,1,1.0
2018-12-10,Georgia,1,0,0,1,1.0
2018-12-10,Florida,0,0,1,1,0.5
2018-12-10,Nebraska,0,0,1,1,0.5
2018-12-09,Massachusetts,1,0,1,2,0.75
2018-12-09,California,1,0,1,2,0.75
2018-12-09,Oregon,10,0,0,10,1.0
2018-12-09,Alabama,1,0,0,1,1.0
2018-12-09,Indiana,0,0,1,1,0.5
2018-12-09,Hawaii,1,1,0,2,0.5
2018-12-09,Louisiana,1,0,0,1,1.0
2018-12-09,South Carolina,0,1,0,1,0.0
2018-12-09,North Carolina,0,1,0,1,0.0
2018-12-09,Washington,1,0,0,1,1.0
2018-12-09,Connecticut,1,0,0,1,1.0
2018-12-09,Missouri,0,0,2,2,0.5
2018-12-09,New Jersey,0,0,1,1,0.5
2018-12-09,Colorado,1,0,0,1,1.0
2018-12-09,Iowa,0,0,1,1,0.5
2018-12-08,Arkansas,1,1,0,2,0.5
2018-12-08,California,2,1,1,4,0.625
2018-12-08,Oregon,1,0,0,1,1.0
2018-12-08,Texas,1,0,1,2,0.75
2018-12-08,Missouri,2,0,0,2,1.0
2018-12-08,Indiana,1,0,1,2,0.75
2018-12-08,Georgia,0,0,1,1,0.5
2018-12-08,Alabama,0,0,1,1,0.5
2018-12-08,Arizona,1,0,1,2,0.75
2018-12-08,Alaska,1,0,0,1,1.0
2018-12-08,Hawaii,0,0,1,1,0.5
2018-12-08,Maryland,1,0,0,1,1.0
2018-12-07,Alabama,4,0,2,6,0.8333333333333333
2018-12-07,Alaska,0,1,0,1,0.0
2018-12-07,Florida,1,1,0,2,0.5
2018-12-07,Illinois,3,0,0,3,1.0
2018-12-07,Massachusetts,1,2,3,6,0.41666666666666663
2018-12-07,California,2,1,0,3,0.6666666666666666
2018-12-07,Indiana,3,0,1,4,0.875
2018-12-07,Kansas,1,0,0,1,1.0
2018-12-07,Louisiana,0,1,0,1,0.0
2018-12-07,Arkansas,2,2,1,5,0.5
2018-12-07,Hawaii,1,0,1,2,0.75
2018-12-07,Maryland,1,0,0,1,1.0
2018-12-07,Connecticut,2,0,0,2,1.0
2018-12-07,New York,1,0,1,2,0.75
2018-12-07,Arizona,1,0,0,1,1.0
2018-12-07,Minnesota,0,0,1,1,0.5
2018-12-06,Colorado,3,2,1,6,0.5833333333333334
2018-12-06,California,3,1,1,5,0.7
2018-12-06,Georgia,1,0,0,1,1.0
2018-12-06,Nebraska,2,0,1,3,0.8333333333333333
2018-12-06,New Jersey,1,0,0,1,1.0
2018-12-06,Massachusetts,1,0,1,2,0.75
2018-12-06,Missouri,0,0,1,1,0.5
2018-12-06,Alabama,1,2,0,3,0.3333333333333333
2018-12-06,Florida,0,1,0,1,0.0
2018-12-06,Arkansas,2,0,0,2,1.0
2018-12-06,Delaware,1,0,0,1,1.0
2018-12-06,Hawaii,1,0,0,1,1.0
2018-12-06,Alaska,1,0,1,2,0.75
2018-12-06,Ohio,1,1,1,3,0.5
2018-12-06,Indiana,0,0,1,1,0.5
2018-12-06,New York,0,1,0,1,0.0
2018-12-05,New York,2,1,1,4,0.625
2018-12-05,Colorado,2,1,1,4,0.625
2018-12-05,Alabama,3,1,0,4,0.75
2018-12-05,North Carolina,0,0,1,1,0.5
2018-12-05,Arkansas,1,0,2,3,0.6666666666666666
2018-12-05,Massachusetts,5,0,2,7,0.8571428571428572
2018-12-05,Georgia,0,0,1,1,0.5
2018-12-05,California,6,1,0,7,0.8571428571428571
2018-12-05,Indiana,1,0,0,1,1.0
2018-12-05,Minnesota,1,0,0,1,1.0
2018-12-05,Delaware,1,0,0,1,1.0
2018-12-05,Texas,0,0,1,1,0.5
2018-12-05,Missouri,0,1,0,1,0.0
2018-12-05,Alaska,1,0,0,1,1.0
2018-12-05,Hawaii,1,0,0,1,1.0
2018-12-04,Texas,1,0,0,1,1.0
2018-12-04,California,5,0,4,9,0.7777777777777778
2018-12-04,Alabama,4,1,0,5,0.8
2018-12-04,Illinois,1,1,0,2,0.5
2018-12-04,Washington,5,0,0,5,1.0
2018-12-04,Maryland,1,0,0,1,1.0
2018-12-04,Delaware,1,0,0,1,1.0
2018-12-04,Hawaii,2,1,0,3,0.6666666666666666
2018-12-04,Georgia,0,0,2,2,0.5
2018-12-04,Massachusetts,0,3,2,5,0.2
2018-12-04,Florida,1,2,0,3,0.3333333333333333
2018-12-04,Indiana,1,2,0,3,0.3333333333333333
2018-12-04,Oregon,1,0,0,1,1.0
2018-12-04,Colorado,2,0,0,2,1.0
2018-12-04,Michigan,1,0,0,1,1.0
2018-12-04,Arkansas,1,2,0,3,0.3333333333333333
2018-12-04,New York,1,0,0,1,1.0
2018-12-04,Missouri,2,0,0,2,1.0
2018-12-04,Iowa,0,1,0,1,0.0
2018-12-04,Louisiana,0,0,1,1,0.5
2018-12-04,Minnesota,0,1,0,1,0.0
2018-12-03,California,5,1,4,10,0.7
2018-12-03,New Jersey,0,0,1,1,0.5
2018-12-03,Louisiana,3,0,1,4,0.875
2018-12-03,Alabama,4,2,2,8,0.625
2018-12-03,Massachusetts,1,1,2,4,0.5
2018-12-03,Indiana,3,0,1,4,0.875
2018-12-03,Hawaii,18,6,12,36,0.6666666666666666
2018-12-03,Nebraska,1,13,0,14,0.07142857142857142
2018-12-03,New York,6,1,2,9,0.7777777777777777
2018-12-03,Arkansas,1,0,1,2,0.75
2018-12-03,Delaware,2,0,1,3,0.8333333333333333
2018-12-03,Minnesota,1,0,0,1,1.0
2018-12-03,Arizona,1,0,1,2,0.75
2018-12-03,Iowa,0,0,1,1,0.5
2018-12-03,Colorado,1,0,0,1,1.0
2018-12-02,Hawaii,1,0,0,1,1.0
2018-12-02,Delaware,0,0,1,1,0.5
2018-12-02,Louisiana,1,0,1,2,0.75
2018-12-02,Colorado,3,0,0,3,1.0
2018-12-02,Alaska,0,1,0,1,0.0
2018-12-02,Alabama,3,0,2,5,0.8
2018-12-02,Arkansas,3,0,1,4,0.875
2018-12-02,California,7,1,1,9,0.8333333333333334
2018-12-02,Florida,1,0,0,1,1.0
2018-12-02,Arizona,1,0,0,1,1.0
2018-12-02,Indiana,1,0,0,1,1.0
2018-12-02,Missouri,1,0,0,1,1.0
2018-12-01,Georgia,2,0,0,2,1.0
2018-12-01,Oregon,1,0,0,1,1.0
2018-12-01,Hawaii,3,0,0,3,1.0
2018-12-01,Alabama,5,0,2,7,0.8571428571428572
2018-12-01,Missouri,1,0,1,2,0.75
2018-12-01,Illinois,0,0,1,1,0.5
2018-12-01,Iowa,1,0,1,2,0.75
2018-12-01,Colorado,0,0,1,1,0.5
2018-12-01,New Jersey,1,0,0,1,1.0
2018-12-01,Arizona,1,0,0,1,1.0
2018-12-01,California,1,0,0,1,1.0
2018-12-01,New York,2,0,0,2,1.0
2018-12-01,Maryland,0,1,0,1,0.0
2018-12-01,Arkansas,2,1,0,3,0.6666666666666666
2018-12-01,Indiana,2,0,0,2,1.0
2018-12-01,Massachusetts,1,0,0,1,1.0
2018-12-01,Kansas,1,0,0,1,1.0
2018-11-30,Iowa,1,0,0,1,1.0
2018-11-30,California,2,1,5,8,0.5625
2018-11-30,Missouri,1,0,0,1,1.0
2018-11-30,Alabama,3,0,0,3,1.0
2018-11-30,Illinois,1,2,1,4,0.375
2018-11-30,Alaska,0,1,0,1,0.0
2018-11-30,Indiana,1,0,3,4,0.625
2018-11-30,Florida,0,0,2,2,0.5
2018-11-30,Massachusetts,2,0,0,2,1.0
2018-11-30,Arkansas,0,0,2,2,0.5
2018-11-30,Pennsylvania,0,1,0,1,0.0
2018-11-30,Michigan,0,1,0,1,0.0
2018-11-30,Colorado,1,0,0,1,1.0
2018-11-30,Maryland,0,1,0,1,0.0
2018-11-30,Hawaii,1,0,0,1,1.0
2018-11-29,Texas,1,0,1,2,0.75
2018-11-29,Arkansas,0,0,2,2,0.5
2018-11-29,Pennsylvania,0,1,0,1,0.0
2018-11-29,California,5,2,2,9,0.6666666666666667
2018-11-29,Delaware,1,0,0,1,1.0
2018-11-29,Missouri,0,1,0,1,0.0
2018-11-29,Indiana,2,1,1,4,0.625
2018-11-29,Louisiana,0,0,1,1,0.5
2018-11-29,Alabama,1,1,0,2,0.5
2018-11-29,Hawaii,2,2,1,5,0.5
2018-11-29,Washington,3,0,0,3,1.0
2018-11-29,Iowa,1,0,0,1,1.0
2018-11-29,Colorado,2,0,1,3,0.8333333333333333
2018-11-29,Alaska,2,0,1,3,0.8333333333333333
2018-11-29,Minnesota,0,0,1,1,0.5
2018-11-29,Massachusetts,3,0,1,4,0.875
2018-11-29,New Mexico,1,0,0,1,1.0
2018-11-29,Georgia,1,0,1,2,0.75
2018-11-29,North Carolina,2,0,0,2,1.0
2018-11-29,Florida,0,1,0,1,0.0
2018-11-29,New Jersey,0,1,0,1,0.0
2018-11-28,California,1,5,1,7,0.21428571428571427
2018-11-28,Florida,0,0,1,1,0.5
2018-11-28,Nebraska,2,0,0,2,1.0
2018-11-28,Missouri,1,0,0,1,1.0
2018-11-28,Indiana,4,1,4,9,0.6666666666666666
2018-11-28,Colorado,3,0,0,3,1.0
2018-11-28,Arkansas,3,3,0,6,0.5
2018-11-28,Hawaii,1,0,3,4,0.625
2018-11-28,Alabama,3,1,0,4,0.75
2018-11-28,Georgia,2,0,0,2,1.0
2018-11-28,Massachusetts,2,0,1,3,0.8333333333333333
2018-11-28,New Hampshire,0,1,0,1,0.0
2018-11-28,Connecticut,1,0,1,2,0.75
2018-11-28,Washington,1,0,0,1,1.0
2018-11-28,Maryland,1,0,0,1,1.0
2018-11-28,Michigan,0,0,1,1,0.5
2018-11-28,Delaware,0,0,1,1,0.5
2018-11-28,New York,2,0,0,2,1.0
2018-11-28,Illinois,1,0,0,1,1.0
2018-11-28,Texas,0,1,0,1,0.0
2018-11-27,Nebraska,0,1,0,1,0.0
2018-11-27,Arkansas,2,0,0,2,1.0
2018-11-27,Washington,4,0,1,5,0.9
2018-11-27,Arizona,1,1,0,2,0.5
2018-11-27,Louisiana,3,0,0,3,1.0
2018-11-27,New York,1,2,1,4,0.375
2018-11-27,Virginia,1,0,0,1,1.0
2018-11-27,Alabama,4,1,1,6,0.75
2018-11-27,California,6,2,3,11,0.6818181818181818
2018-11-27,Massachusetts,3,0,0,3,1.0
2018-11-27,Missouri,2,0,1,3,0.8333333333333333
2018-11-27,Kansas,0,0,1,1,0.5
2018-11-27,Florida,1,1,1,3,0.5
2018-11-27,Iowa,0,1,2,3,0.3333333333333333
2018-11-27,Tennessee,0,0,1,1,0.5
2018-11-27,Hawaii,3,0,0,3,1.0
2018-11-27,Illinois,1,0,1,2,0.75
2018-11-27,Colorado,1,1,0,2,0.5
2018-11-27,Georgia,2,1,0,3,0.6666666666666666
2018-11-27,Texas,0,0,1,1,0.5
2018-11-27,Alaska,3,1,0,4,0.75
2018-11-27,Pennsylvania,0,1,0,1,0.0
2018-11-27,Indiana,1,0,1,2,0.75
2018-11-27,Ohio,1,0,0,1,1.0
2018-11-26,Arizona,2,1,1,4,0.625
2018-11-26,Massachusetts,6,2,2,10,0.7
2018-11-26,California,5,4,1,10,0.55
2018-11-26,Indiana,3,0,2,5,0.8
2018-11-26,Michigan,3,0,0,3,1.0
2018-11-26,Arkansas,4,0,1,5,0.9
2018-11-26,New Jersey,1,0,0,1,1.0
2018-11-26,Oregon,0,1,0,1,0.0
2018-11-26,Alabama,4,0,2,6,0.8333333333333333
2018-11-26,Colorado,1,2,0,3,0.3333333333333333
2018-11-26,Nebraska,0,1,0,1,0.0
2018-11-26,Florida,0,1,0,1,0.0
2018-11-26,Georgia,2,1,1,4,0.625
2018-11-26,Louisiana,0,1,1,2,0.25
2018-11-26,New York,0,0,1,1,0.5
2018-11-26,Missouri,0,0,2,2,0.5
2018-11-26,Hawaii,1,0,0,1,1.0
2018-11-26,Maryland,0,1,0,1,0.0
2018-11-26,Illinois,1,0,1,2,0.75
2018-11-26,Minnesota,1,0,0,1,1.0
2018-11-25,Oklahoma,0,0,2,2,0.5
2018-11-25,Georgia,2,0,0,2,1.0
2018-11-25,Arizona,1,0,1,2,0.75
2018-11-25,Iowa,0,2,0,2,0.0
2018-11-25,California,8,2,3,13,0.7307692307692308
2018-11-25,Alabama,3,1,1,5,0.7
2018-11-25,New Jersey,0,1,0,1,0.0
2018-11-25,Hawaii,1,0,1,2,0.75
2018-11-25,Massachusetts,3,1,2,6,0.6666666666666666
2018-11-25,Florida,1,1,0,2,0.5
2018-11-25,Maryland,0,1,0,1,0.0
2018-11-25,New York,2,0,2,4,0.75
2018-11-25,Colorado,2,0,0,2,1.0
2018-11-25,Arkansas,0,0,2,2,0.5
2018-11-25,Delaware,0,1,0,1,0.0
2018-11-25,Washington,1,0,0,1,1.0
2018-11-25,Alaska,1,0,0,1,1.0
2018-11-25,Indiana,2,0,0,2,1.0
2018-11-25,Kentucky,0,0,1,1,0.5
2018-11-25,Illinois,1,0,0,1,1.0
2018-11-24,Arizona,1,1,1,3,0.5
2018-11-24,Massachusetts,2,1,3,6,0.5833333333333333
2018-11-24,Illinois,2,0,1,3,0.8333333333333333
2018-11-24,Florida,1,0,1,2,0.75
2018-11-24,Ohio,1,0,0,1,1.0
2018-11-24,California,3,1,0,4,0.75
2018-11-24,Arkansas,4,2,3,9,0.611111111111111
2018-11-24,Maryland,1,0,0,1,1.0
2018-11-24,Kansas,1,0,0,1,1.0
2018-11-24,Louisiana,0,0,1,1,0.5
2018-11-24,Kentucky,0,0,1,1,0.5
2018-11-24,Hawaii,3,0,1,4,0.875
2018-11-24,Alabama,6,0,3,9,0.8333333333333333
2018-11-24,New York,2,0,0,2,1.0
2018-11-24,Texas,1,0,0,1,1.0
2018-11-24,Missouri,1,0,0,1,1.0
2018-11-24,Indiana,2,0,0,2,1.0
2018-11-24,Delaware,1,0,0,1,1.0
2018-11-24,Oregon,1,0,0,1,1.0
2018-11-24,Georgia,1,0,0,1,1.0
2018-11-24,Colorado,0,1,0,1,0.0
2018-11-24,Alaska,2,0,0,2,1.0
2018-11-23,Arkansas,2,0,2,4,0.75
2018-11-23,California,8,1,1,10,0.8500000000000001
2018-11-23,Indiana,2,1,3,6,0.5833333333333333
2018-11-23,Colorado,2,0,1,3,0.8333333333333333
2018-11-23,North Dakota,1,0,0,1,1.0
2018-11-23,Arizona,2,0,0,2,1.0
2018-11-23,Florida,4,1,1,6,0.75
2018-11-23,New York,4,0,0,4,1.0
2018-11-23,Texas,1,0,0,1,1.0
2018-11-23,Nebraska,4,1,0,5,0.8
2018-11-23,Massachusetts,5,0,2,7,0.8571428571428572
2018-11-23,Alabama,4,0,0,4,1.0
2018-11-23,Alaska,2,0,0,2,1.0
2018-11-23,Washington,1,0,0,1,1.0
2018-11-23,New Jersey,0,0,1,1,0.5
2018-11-23,Hawaii,2,1,0,3,0.6666666666666666
2018-11-23,Delaware,1,0,0,1,1.0
2018-11-23,Georgia,1,1,0,2,0.5
2018-11-23,Minnesota,1,0,0,1,1.0
2018-11-23,Iowa,0,0,2,2,0.5
2018-11-23,Missouri,1,0,1,2,0.75
2018-11-23,Maryland,1,0,0,1,1.0
2018-11-22,California,2,0,0,2,1.0
2018-11-22,Illinois,2,0,0,2,1.0
2018-11-22,Alabama,1,0,0,1,1.0
2018-11-22,Nebraska,2,1,0,3,0.6666666666666666
2018-11-22,Indiana,1,0,1,2,0.75
2018-11-22,Arkansas,1,1,0,2,0.5
2018-11-22,Louisiana,2,0,0,2,1.0
2018-11-22,Michigan,1,0,0,1,1.0
2018-11-22,Delaware,1,0,0,1,1.0
2018-11-22,Maryland,1,0,0,1,1.0
2018-11-22,Washington,0,1,0,1,0.0
2018-11-21,California,6,0,0,6,1.0
2018-11-21,Colorado,1,0,0,1,1.0
2018-11-21,New York,6,0,1,7,0.9285714285714285
2018-11-21,Louisiana,0,1,0,1,0.0
2018-11-21,Idaho,2,0,0,2,1.0
2018-11-21,Virginia,1,0,0,1,1.0
2018-11-21,Alabama,1,0,0,1,1.0
2018-11-21,Illinois,1,0,0,1,1.0
2018-11-21,Georgia,0,0,1,1,0.5
2018-11-21,Iowa,0,0,1,1,0.5
2018-11-21,Hawaii,0,1,0,1,0.0
2018-11-21,Alaska,1,0,0,1,1.0
2018-11-21,Nebraska,1,0,0,1,1.0
2018-11-21,Massachusetts,1,1,0,2,0.5
2018-11-21,Delaware,1,0,0,1,1.0
2018-11-21,Arkansas,1,0,0,1,1.0
2018-11-20,Hawaii,1,0,1,2,0.75
2018-11-20,California,4,0,0,4,1.0
2018-11-20,Massachusetts,0,0,1,1,0.5
2018-11-20,Illinois,0,0,1,1,0.5
2018-11-20,Indiana,2,0,0,2,1.0
2018-11-20,New York,2,0,0,2,1.0
2018-11-20,Louisiana,0,0,1,1,0.5
2018-11-20,Nebraska,1,0,0,1,1.0
2018-11-20,Alabama,0,1,1,2,0.25
2018-11-19,California,4,1,0,5,0.8
2018-11-19,New York,1,0,1,2,0.75
2018-11-19,Louisiana,0,0,2,2,0.5
2018-11-19,Delaware,2,0,0,2,1.0
2018-11-19,Iowa,0,0,1,1,0.5
2018-11-19,Minnesota,0,1,0,1,0.0
2018-11-19,Indiana,1,0,0,1,1.0
2018-11-19,Alabama,2,0,0,2,1.0
2018-11-19,Hawaii,1,0,0,1,1.0
2018-11-19,Rhode Island,0,0,1,1,0.5
2018-11-19,Illinois,1,0,0,1,1.0
2018-11-19,Florida,1,0,0,1,1.0
2018-11-19,Texas,1,0,0,1,1.0
2018-11-19,Washington,1,0,0,1,1.0
2018-11-18,Colorado,4,0,1,5,0.9
2018-11-18,California,5,0,1,6,0.9166666666666667
2018-11-18,Montana,1,0,0,1,1.0
2018-11-18,Maryland,0,0,1,1,0.5
2018-11-18,Alabama,4,0,2,6,0.8333333333333333
2018-11-18,Massachusetts,1,0,1,2,0.75
2018-11-18,Missouri,0,1,0,1,0.0
2018-11-18,North Carolina,0,0,1,1,0.5
2018-11-18,Arkansas,0,0,1,1,0.5
2018-11-18,Florida,1,0,0,1,1.0
2018-11-18,Connecticut,1,0,0,1,1.0
2018-11-18,Michigan,1,0,0,1,1.0
2018-11-18,Delaware,1,0,0,1,1.0
2018-11-18,Indiana,1,0,0,1,1.0
2018-11-18,Nebraska,0,0,1,1,0.5
2018-11-18,Georgia,1,0,0,1,1.0
2018-11-18,Illinois,1,0,0,1,1.0
2018-11-17,Arizona,0,0,1,1,0.5
2018-11-17,Louisiana,2,0,1,3,0.8333333333333333
2018-11-17,California,8,1,1,10,0.8500000000000001
2018-11-17,Maryland,1,0,0,1,1.0
2018-11-17,Georgia,0,0,1,1,0.5
2018-11-17,Texas,0,1,0,1,0.0
2018-11-17,Arkansas,5,2,0,7,0.7142857142857143
2018-11-17,Connecticut,0,0,1,1,0.5
2018-11-17,Alabama,2,2,0,4,0.5
2018-11-17,Virginia,1,0,0,1,1.0
2018-11-17,Nebraska,1,0,1,2,0.75
2018-11-17,New York,0,0,1,1,0.5
2018-11-17,Indiana,1,0,0,1,1.0
2018-11-16,Alabama,3,0,1,4,0.875
2018-11-16,Alaska,1,1,0,2,0.5
2018-11-16,California,8,1,1,10,0.8500000000000001
2018-11-16,Idaho,1,0,0,1,1.0
2018-11-16,Florida,2,0,0,2,1.0
2018-11-16,Nebraska,1,0,2,3,0.6666666666666666
2018-11-16,Texas,1,0,0,1,1.0
2018-11-16,Colorado,1,0,0,1,1.0
2018-11-16,Indiana,4,0,0,4,1.0
2018-11-16,Maryland,0,0,2,2,0.5
2018-11-16,New York,1,0,0,1,1.0
2018-11-16,Arkansas,0,1,1,2,0.25
2018-11-16,Massachusetts,1,0,0,1,1.0
2018-11-16,Connecticut,1,0,0,1,1.0
2018-11-15,Florida,3,0,1,4,0.875
2018-11-15,Missouri,1,0,0,1,1.0
2018-11-15,California,6,3,0,9,0.6666666666666666
2018-11-15,Delaware,0,1,1,2,0.25
2018-11-15,Massachusetts,3,0,0,3,1.0
2018-11-15,Alabama,3,1,2,6,0.6666666666666666
2018-11-15,Arkansas,2,1,0,3,0.6666666666666666
2018-11-15,Texas,1,0,0,1,1.0
2018-11-15,Alaska,2,0,0,2,1.0
2018-11-15,Hawaii,3,0,0,3,1.0
2018-11-15,Indiana,1,0,0,1,1.0
2018-11-15,Arizona,1,0,0,1,1.0
2018-11-15,Michigan,0,1,0,1,0.0
2018-11-14,Arkansas,0,1,1,2,0.25
2018-11-14,Hawaii,0,0,1,1,0.5
2018-11-14,Georgia,1,0,1,2,0.75
2018-11-14,Massachusetts,1,2,0,3,0.3333333333333333
2018-11-14,Maryland,1,0,1,2,0.75
2018-11-14,Colorado,0,1,0,1,0.0
2018-11-14,California,2,2,1,5,0.5
2018-11-14,Florida,1,0,0,1,1.0
2018-11-14,Louisiana,2,0,0,2,1.0
2018-11-14,New York,1,0,0,1,1.0
2018-11-14,Missouri,0,0,1,1,0.5
2018-11-14,Ohio,0,0,1,1,0.5
2018-11-14,Alabama,2,0,0,2,1.0
2018-11-14,Arizona,1,0,0,1,1.0
2018-11-13,Missouri,1,0,0,1,1.0
2018-11-13,Florida,3,0,0,3,1.0
2018-11-13,Washington,1,0,1,2,0.75
2018-11-13,New Mexico,0,1,0,1,0.0
2018-11-13,Massachusetts,2,0,2,4,0.75
2018-11-13,Delaware,1,0,0,1,1.0
2018-11-13,Iowa,2,0,0,2,1.0
2018-11-13,Indiana,2,0,0,2,1.0
2018-11-13,Alabama,1,0,0,1,1.0
2018-11-13,Arkansas,1,0,0,1,1.0
2018-11-13,Nebraska,1,0,0,1,1.0
2018-11-13,California,2,0,2,4,0.75
2018-11-13,Idaho,1,0,0,1,1.0
2018-11-13,Hawaii,1,0,1,2,0.75
2018-11-13,Illinois,2,0,0,2,1.0
2018-11-13,Louisiana,1,0,0,1,1.0
2018-11-13,Arizona,1,0,0,1,1.0
2018-11-12,Michigan,0,1,0,1,0.0
2018-11-12,California,6,2,0,8,0.75
2018-11-12,Arkansas,1,0,0,1,1.0
2018-11-12,Maryland,2,1,0,3,0.6666666666666666
2018-11-12,Louisiana,1,0,0,1,1.0
2018-11-12,Kansas,1,0,0,1,1.0
2018-11-12,Indiana,3,2,3,8,0.5625
2018-11-12,Alaska,1,0,0,1,1.0
2018-11-12,Colorado,0,1,0,1,0.0
2018-11-12,Arizona,3,1,0,4,0.75
2018-11-12,Minnesota,0,0,1,1,0.5
2018-11-12,Alabama,1,0,0,1,1.0
2018-11-12,Nebraska,1,0,0,1,1.0
2018-11-12,Georgia,0,0,1,1,0.5
2018-11-11,California,2,3,1,6,0.41666666666666663
2018-11-11,Nebraska,1,0,1,2,0.75
2018-11-11,Alabama,4,0,1,5,0.9
2018-11-11,Indiana,2,1,0,3,0.6666666666666666
2018-11-11,Colorado,1,1,1,3,0.5
2018-11-11,New York,2,0,1,3,0.8333333333333333
2018-11-11,Hawaii,3,0,0,3,1.0
2018-11-11,New Jersey,0,1,0,1,0.0
2018-11-11,Arkansas,3,1,1,5,0.7
2018-11-11,Alaska,1,1,0,2,0.5
2018-11-11,Wisconsin,1,0,0,1,1.0
2018-11-11,Louisiana,0,1,1,2,0.25
2018-11-11,Illinois,0,1,0,1,0.0
2018-11-11,Massachusetts,0,0,1,1,0.5
2018-11-11,Missouri,2,0,0,2,1.0
2018-11-10,California,13,4,0,17,0.7647058823529411
2018-11-10,Alabama,3,3,0,6,0.5
2018-11-10,Indiana,1,0,0,1,1.0
2018-11-10,Louisiana,3,0,0,3,1.0
2018-11-10,Arizona,1,1,0,2,0.5
2018-11-10,Florida,1,0,0,1,1.0
2018-11-10,Washington,0,1,0,1,0.0
2018-11-10,Missouri,2,0,1,3,0.8333333333333333
2018-11-10,Delaware,0,1,0,1,0.0
2018-11-10,Massachusetts,0,0,2,2,0.5
2018-11-10,Arkansas,3,2,0,5,0.6
2018-11-10,Alaska,0,0,1,1,0.5
2018-11-10,Georgia,0,1,0,1,0.0
2018-11-09,New York,0,1,0,1,0.0
2018-11-09,California,4,0,0,4,1.0
2018-11-09,Arkansas,3,0,2,5,0.8
2018-11-09,Indiana,2,0,1,3,0.8333333333333333
2018-11-09,Florida,1,0,0,1,1.0
2018-11-09,Illinois,1,0,0,1,1.0
2018-11-09,Louisiana,4,0,1,5,0.9
2018-11-09,Connecticut,0,0,1,1,0.5
2018-11-09,Hawaii,1,0,0,1,1.0
2018-11-09,Iowa,0,0,1,1,0.5
2018-11-09,Alabama,1,0,0,1,1.0
2018-11-09,Colorado,0,0,1,1,0.5
2018-11-09,Maryland,1,0,0,1,1.0
2018-11-09,Alaska,1,0,0,1,1.0
2018-11-09,New Hampshire,0,1,0,1,0.0
2018-11-08,Florida,2,0,0,2,1.0
2018-11-08,Indiana,2,0,2,4,0.75
2018-11-08,California,2,1,0,3,0.6666666666666666
2018-11-08,Washington,1,0,0,1,1.0
2018-11-08,Arkansas,4,0,0,4,1.0
2018-11-08,Colorado,2,0,0,2,1.0
2018-11-08,Connecticut,1,0,0,1,1.0
2018-11-07,California,6,0,1,7,0.9285714285714285
2018-11-07,Washington,1,0,0,1,1.0
2018-11-07,Alabama,9,1,0,10,0.9
2018-11-07,Missouri,1,0,0,1,1.0
2018-11-07,Delaware,0,0,1,1,0.5
2018-11-07,Massachusetts,1,0,0,1,1.0
2018-11-07,Illinois,0,0,1,1,0.5
2018-11-07,Mississippi,0,1,0,1,0.0
2018-11-07,Maine,0,0,1,1,0.5
2018-11-06,Colorado,0,0,1,1,0.5
2018-11-06,Iowa,0,0,1,1,0.5
2018-11-06,California,6,1,0,7,0.8571428571428571
2018-11-06,Arizona,2,1,0,3,0.6666666666666666
2018-11-06,Massachusetts,1,0,1,2,0.75
2018-11-06,Alabama,5,0,0,5,1.0
2018-11-06,Texas,1,0,1,2,0.75
2018-11-06,Delaware,2,0,1,3,0.8333333333333333
2018-11-06,Idaho,1,0,0,1,1.0
2018-11-06,Arkansas,1,0,0,1,1.0
2018-11-06,Nebraska,0,1,0,1,0.0
2018-11-06,Indiana,2,0,0,2,1.0
2018-11-06,Georgia,1,0,0,1,1.0
2018-11-05,Virginia,1,0,0,1,1.0
2018-11-05,New York,1,0,0,1,1.0
2018-11-05,Colorado,1,0,0,1,1.0
2018-11-05,Arkansas,2,0,0,2,1.0
2018-11-05,Indiana,1,0,0,1,1.0
2018-11-05,Alaska,1,0,0,1,1.0
2018-11-05,California,1,0,0,1,1.0
2018-11-05,Georgia,1,0,1,2,0.75
2018-11-05,Maryland,0,0,1,1,0.5
2018-11-05,Hawaii,0,1,1,2,0.25
2018-11-05,Nebraska,1,0,1,2,0.75
2018-11-05,Massachusetts,1,0,1,2,0.75
2018-11-05,Illinois,0,0,1,1,0.5
2018-11-05,Texas,0,0,1,1,0.5
2018-11-04,Colorado,1,0,1,2,0.75
2018-11-04,California,9,0,1,10,0.9500000000000001
2018-11-04,Alabama,1,2,0,3,0.3333333333333333
2018-11-04,Washington,1,0,1,2,0.75
2018-11-04,Delaware,2,0,0,2,1.0
2018-11-04,Minnesota,0,0,1,1,0.5
2018-11-04,Massachusetts,1,0,0,1,1.0
2018-11-04,Arizona,1,0,0,1,1.0
2018-11-03,California,6,0,1,7,0.9285714285714285
2018-11-03,Florida,1,0,0,1,1.0
2018-11-03,Louisiana,1,1,0,2,0.5
2018-11-03,Alabama,2,1,0,3,0.6666666666666666
2018-11-03,Hawaii,2,0,0,2,1.0
2018-11-03,Alaska,1,0,0,1,1.0
2018-11-03,Indiana,1,0,0,1,1.0
2018-11-03,Missouri,0,1,0,1,0.0
2018-11-03,Maryland,1,0,0,1,1.0
2018-11-03,Colorado,1,0,1,2,0.75
2018-11-03,Georgia,2,0,0,2,1.0
2018-11-03,Massachusetts,0,2,0,2,0.0
2018-11-03,New York,0,0,1,1,0.5
2018-11-03,Arizona,0,0,1,1,0.5
2018-11-03,Iowa,1,0,0,1,1.0
2018-11-02,Arkansas,1,1,1,3,0.5
2018-11-02,Washington,0,1,0,1,0.0
2018-11-02,Delaware,1,0,0,1,1.0
2018-11-02,Massachusetts,0,0,1,1,0.5
2018-11-02,Alabama,1,0,0,1,1.0
2018-11-02,Georgia,1,0,0,1,1.0
2018-11-02,Indiana,1,0,0,1,1.0
2018-11-02,Missouri,0,0,1,1,0.5
2018-11-02,Iowa,1,0,0,1,1.0
2018-11-02,Oregon,0,1,0,1,0.0
2018-11-02,Alaska,1,0,0,1,1.0
2018-11-02,Hawaii,1,0,0,1,1.0
2018-11-02,Colorado,0,0,1,1,0.5
2018-11-02,California,1,0,0,1,1.0
2018-11-01,Arkansas,2,1,1,4,0.625
2018-11-01,Massachusetts,1,0,0,1,1.0
2018-11-01,California,4,0,1,5,0.9
2018-11-01,Hawaii,1,0,0,1,1.0
2018-11-01,Alabama,0,1,0,1,0.0
2018-11-01,Texas,1,0,1,2,0.75
2018-11-01,Delaware,0,1,0,1,0.0
2018-11-01,Illinois,0,1,1,2,0.25
2018-11-01,Maryland,0,0,1,1,0.5
2018-11-01,Iowa,3,0,0,3,1.0
2018-11-01,Indiana,0,0,1,1,0.5
2018-11-01,Washington,1,0,0,1,1.0
2018-10-31,Nebraska,0,1,0,1,0.0
2018-10-31,Hawaii,1,1,0,2,0.5
2018-10-31,Washington,3,0,0,3,1.0
2018-10-31,Florida,0,0,1,1,0.5
2018-10-31,Arkansas,0,2,0,2,0.0
2018-10-31,Iowa,0,1,0,1,0.0
2018-10-31,New York,0,0,1,1,0.5
2018-10-31,Louisiana,1,0,0,1,1.0
2018-10-31,New Hampshire,1,0,0,1,1.0
2018-10-31,California,1,0,0,1,1.0
2018-10-31,Nevada,0,1,0,1,0.0
2018-10-30,Indiana,3,0,2,5,0.8
2018-10-30,Massachusetts,2,1,0,3,0.6666666666666666
2018-10-30,California,0,2,1,3,0.16666666666666666
2018-10-30,Alabama,0,0,4,4,0.5
2018-10-30,Hawaii,1,0,0,1,1.0
2018-10-30,Illinois,2,0,0,2,1.0
2018-10-30,Ohio,1,0,0,1,1.0
2018-10-30,Florida,2,0,0,2,1.0
2018-10-30,New Jersey,0,0,1,1,0.5
2018-10-30,Delaware,1,0,0,1,1.0
2018-10-30,Georgia,1,0,0,1,1.0
2018-10-29,New York,0,0,1,1,0.5
2018-10-29,Alabama,1,1,0,2,0.5
2018-10-29,Georgia,0,1,0,1,0.0
2018-10-29,California,4,1,2,7,0.7142857142857142
2018-10-29,Massachusetts,3,0,0,3,1.0
2018-10-29,Hawaii,0,0,1,1,0.5
2018-10-29,Maryland,0,0,2,2,0.5
2018-10-29,Oregon,1,0,0,1,1.0
2018-10-29,Louisiana,0,1,0,1,0.0
2018-10-29,Ohio,1,0,0,1,1.0
2018-10-29,Colorado,1,0,0,1,1.0
2018-10-29,Kansas,0,0,1,1,0.5
2018-10-29,Delaware,1,0,0,1,1.0
2018-10-29,Indiana,0,1,0,1,0.0
2018-10-29,North Dakota,0,1,0,1,0.0
2018-10-29,Arkansas,1,0,0,1,1.0
2018-10-29,Florida,1,0,0,1,1.0
2018-10-29,Illinois,0,0,1,1,0.5
2018-10-28,Arkansas,2,0,0,2,1.0
2018-10-28,Indiana,1,0,0,1,1.0
2018-10-28,California,1,1,0,2,0.5
2018-10-28,Iowa,0,1,0,1,0.0
2018-10-28,Alabama,2,1,0,3,0.6666666666666666
2018-10-28,Missouri,1,0,0,1,1.0
2018-10-28,Florida,1,0,0,1,1.0
2018-10-28,Massachusetts,1,0,0,1,1.0
2018-10-27,Alabama,2,0,0,2,1.0
2018-10-27,Oregon,1,0,0,1,1.0
2018-10-27,Connecticut,2,0,0,2,1.0
2018-10-27,California,1,0,0,1,1.0
2018-10-27,Arkansas,1,0,0,1,1.0
2018-10-27,Indiana,1,0,0,1,1.0
2018-10-27,Florida,1,0,0,1,1.0
2018-10-27,Washington,1,0,0,1,1.0
2018-10-27,Massachusetts,0,0,1,1,0.5
2018-10-26,Massachusetts,0,0,1,1,0.5
2018-10-26,Alabama,2,0,1,3,0.8333333333333333
2018-10-26,California,3,0,1,4,0.875
2018-10-26,Washington,1,1,0,2,0.5
2018-10-26,Delaware,0,0,1,1,0.5
2018-10-26,Nebraska,1,0,0,1,1.0
2018-10-26,Indiana,1,0,0,1,1.0
2018-10-25,Alaska,1,0,0,1,1.0
2018-10-25,Arkansas,3,0,0,3,1.0
2018-10-25,Maryland,2,1,2,5,0.6000000000000001
2018-10-25,Arizona,1,0,0,1,1.0
2018-10-25,Indiana,2,0,0,2,1.0
2018-10-25,Alabama,2,1,0,3,0.6666666666666666
2018-10-25,Washington,0,1,0,1,0.0
2018-10-25,California,2,2,1,5,0.5
2018-10-25,Hawaii,1,1,2,4,0.5
2018-10-25,New York,1,0,0,1,1.0
2018-10-25,Massachusetts,2,0,0,2,1.0
2018-10-25,Missouri,1,0,0,1,1.0
2018-10-25,Florida,0,0,1,1,0.5
2018-10-25,Texas,1,0,0,1,1.0
2018-10-24,Alabama,3,0,1,4,0.875
2018-10-24,Massachusetts,3,1,0,4,0.75
2018-10-24,Colorado,1,0,0,1,1.0
2018-10-24,Arkansas,0,0,2,2,0.5
2018-10-24,California,1,0,1,2,0.75
2018-10-24,Georgia,2,0,0,2,1.0
2018-10-24,Hawaii,2,0,0,2,1.0
2018-10-24,New York,0,0,2,2,0.5
2018-10-24,Missouri,1,0,0,1,1.0
2018-10-24,Wisconsin,1,0,0,1,1.0
2018-10-24,Nebraska,1,0,0,1,1.0
2018-10-24,Illinois,1,0,0,1,1.0
2018-10-24,Ohio,0,0,1,1,0.5
2018-10-24,Indiana,1,0,0,1,1.0
2018-10-23,Massachusetts,2,0,1,3,0.8333333333333333
2018-10-23,Oregon,1,1,0,2,0.5
2018-10-23,Alabama,0,0,1,1,0.5
2018-10-23,California,2,2,2,6,0.5
2018-10-23,Hawaii,2,0,0,2,1.0
2018-10-23,Virginia,1,0,0,1,1.0
2018-10-23,Arkansas,1,0,0,1,1.0
2018-10-23,Florida,1,0,0,1,1.0
2018-10-23,Indiana,0,0,1,1,0.5
2018-10-23,North Carolina,1,0,0,1,1.0
2018-10-23,New York,2,0,0,2,1.0
2018-10-23,Arizona,1,0,0,1,1.0
2018-10-23,New Mexico,1,0,0,1,1.0
2018-10-23,Louisiana,1,0,0,1,1.0
2018-10-23,Texas,1,0,0,1,1.0
2018-10-22,Hawaii,2,0,0,2,1.0
2018-10-22,New York,1,0,0,1,1.0
2018-10-22,North Carolina,1,0,0,1,1.0
2018-10-22,Arkansas,0,1,0,1,0.0
2018-10-22,Massachusetts,2,1,0,3,0.6666666666666666
2018-10-22,Indiana,2,0,1,3,0.8333333333333333
2018-10-22,Pennsylvania,1,0,0,1,1.0
2018-10-22,Delaware,0,1,0,1,0.0
2018-10-22,Missouri,1,0,0,1,1.0
2018-10-22,Nebraska,0,1,0,1,0.0
2018-10-22,Arizona,2,0,0,2,1.0
2018-10-22,Maryland,0,0,1,1,0.5
2018-10-22,Alabama,1,0,0,1,1.0
2018-10-22,Georgia,0,0,1,1,0.5
2018-10-21,New Jersey,1,0,0,1,1.0
2018-10-21,Delaware,0,0,1,1,0.5
2018-10-21,Alabama,2,0,3,5,0.7
2018-10-21,Nebraska,0,0,1,1,0.5
2018-10-21,Massachusetts,2,0,2,4,0.75
2018-10-21,Georgia,0,0,2,2,0.5
2018-10-21,Arizona,0,0,1,1,0.5
2018-10-21,Arkansas,2,0,1,3,0.8333333333333333
2018-10-21,Alaska,1,0,0,1,1.0
2018-10-21,Missouri,1,0,2,3,0.6666666666666666
2018-10-20,California,1,1,1,3,0.5
2018-10-20,North Carolina,1,0,0,1,1.0
2018-10-20,Louisiana,2,0,0,2,1.0
2018-10-20,Florida,0,1,0,1,0.0
2018-10-20,Maine,2,0,0,2,1.0
2018-10-20,Washington,1,0,0,1,1.0
2018-10-20,Massachusetts,0,1,1,2,0.25
2018-10-20,Nebraska,0,1,0,1,0.0
2018-10-20,Maryland,1,1,0,2,0.5
2018-10-20,Hawaii,1,0,0,1,1.0
2018-10-20,Alabama,0,0,1,1,0.5
2018-10-20,New York,1,0,0,1,1.0
2018-10-19,Florida,0,1,0,1,0.0
2018-10-19,Nebraska,1,0,0,1,1.0
2018-10-19,Delaware,3,0,0,3,1.0
2018-10-19,New York,1,0,0,1,1.0
2018-10-19,California,2,0,3,5,0.7
2018-10-19,Arizona,0,1,0,1,0.0
2018-10-19,Arkansas,1,0,0,1,1.0
2018-10-19,Indiana,2,0,1,3,0.8333333333333333
2018-10-19,Hawaii,0,0,2,2,0.5
2018-10-19,Missouri,1,0,0,1,1.0
2018-10-19,Alabama,1,0,0,1,1.0
2018-10-19,Maryland,1,0,0,1,1.0
2018-10-19,Washington,2,0,0,2,1.0
2018-10-19,Louisiana,1,0,0,1,1.0
2018-10-19,Alaska,0,0,1,1,0.5
2018-10-18,Arkansas,4,0,0,4,1.0
2018-10-18,California,5,2,0,7,0.7142857142857143
2018-10-18,Illinois,0,0,1,1,0.5
2018-10-18,Washington,1,0,0,1,1.0
2018-10-18,New York,0,1,2,3,0.3333333333333333
2018-10-18,Maine,0,1,0,1,0.0
2018-10-18,Massachusetts,2,0,1,3,0.8333333333333333
2018-10-18,Indiana,4,0,1,5,0.9
2018-10-18,Alabama,4,0,0,4,1.0
2018-10-18,Hawaii,1,0,0,1,1.0
2018-10-18,Colorado,1,0,0,1,1.0
2018-10-18,Delaware,1,0,1,2,0.75
2018-10-18,Oklahoma,0,1,0,1,0.0
2018-10-18,Georgia,0,0,1,1,0.5
2018-10-18,Louisiana,1,0,0,1,1.0
2018-10-17,Massachusetts,4,2,0,6,0.6666666666666666
2018-10-17,Florida,2,0,0,2,1.0
2018-10-17,California,3,2,1,6,0.5833333333333334
2018-10-17,South Carolina,1,0,0,1,1.0
2018-10-17,Alabama,1,0,0,1,1.0
2018-10-17,Arkansas,1,0,1,2,0.75
2018-10-17,Hawaii,0,0,1,1,0.5
2018-10-17,Indiana,2,1,1,4,0.625
2018-10-17,Louisiana,2,0,0,2,1.0
2018-10-17,Alaska,2,0,0,2,1.0
2018-10-17,Colorado,1,0,0,1,1.0
2018-10-17,Georgia,0,0,1,1,0.5
2018-10-17,Kentucky,1,0,1,2,0.75
2018-10-17,Oregon,0,0,1,1,0.5
2018-10-17,New York,1,0,0,1,1.0
2018-10-17,Maryland,0,1,0,1,0.0
2018-10-17,Washington,1,0,0,1,1.0
2018-10-17,Delaware,0,0,1,1,0.5
2018-10-16,New Jersey,0,0,1,1,0.5
2018-10-16,Texas,0,1,0,1,0.0
2018-10-16,Arkansas,3,0,1,4,0.875
2018-10-16,Washington,2,0,0,2,1.0
2018-10-16,Alabama,4,0,0,4,1.0
2018-10-16,Arizona,0,0,1,1,0.5
2018-10-16,California,2,1,0,3,0.6666666666666666
2018-10-16,Massachusetts,6,1,0,7,0.8571428571428571
2018-10-16,Kentucky,1,0,0,1,1.0
2018-10-16,New York,1,2,0,3,0.3333333333333333
2018-10-16,North Carolina,1,0,0,1,1.0
2018-10-16,Nebraska,1,0,0,1,1.0
2018-10-16,Florida,2,0,0,2,1.0
2018-10-16,Indiana,1,0,0,1,1.0
2018-10-16,Idaho,0,0,1,1,0.5
2018-10-16,Illinois,1,1,1,3,0.5
2018-10-16,Hawaii,0,1,0,1,0.0
2018-10-16,Missouri,1,0,0,1,1.0
2018-10-16,Maryland,1,0,0,1,1.0
2018-10-16,Oklahoma,1,0,0,1,1.0
2018-10-16,Delaware,1,0,0,1,1.0
2018-10-16,Alaska,1,0,0,1,1.0
2018-10-16,Colorado,0,1,0,1,0.0
2018-10-15,Washington,2,0,0,2,1.0
2018-10-15,California,9,2,4,15,0.7333333333333333
2018-10-15,New York,3,2,0,5,0.6
2018-10-15,Hawaii,2,1,1,4,0.625
2018-10-15,Massachusetts,4,1,2,7,0.7142857142857142
2018-10-15,Arkansas,2,0,0,2,1.0
2018-10-15,Louisiana,1,0,0,1,1.0
2018-10-15,Michigan,1,0,0,1,1.0
2018-10-15,Kansas,1,0,0,1,1.0
2018-10-15,Maryland,1,0,0,1,1.0
2018-10-15,North Dakota,1,0,0,1,1.0
2018-10-15,Oklahoma,1,1,0,2,0.5
2018-10-15,Texas,1,0,0,1,1.0
2018-10-15,Florida,3,0,0,3,1.0
2018-10-15,Connecticut,1,0,0,1,1.0
2018-10-15,Alabama,4,0,1,5,0.9
2018-10-15,Indiana,1,0,1,2,0.75
2018-10-15,Colorado,0,0,1,1,0.5
2018-10-15,Delaware,0,1,1,2,0.25
2018-10-15,Missouri,0,1,0,1,0.0
2018-10-15,Arizona,2,0,0,2,1.0
2018-10-15,Georgia,0,1,1,2,0.25
2018-10-15,New Jersey,1,0,0,1,1.0
2018-10-15,Iowa,0,0,1,1,0.5
2018-10-15,Alaska,0,1,0,1,0.0
2018-10-14,California,4,1,0,5,0.8
2018-10-14,Hawaii,1,0,0,1,1.0
2018-10-14,Alabama,3,0,2,5,0.8
2018-10-14,Wisconsin,1,0,0,1,1.0
2018-10-14,Maryland,1,0,1,2,0.75
2018-10-14,Florida,1,2,0,3,0.3333333333333333
2018-10-14,Oklahoma,0,0,2,2,0.5
2018-10-14,Georgia,3,0,0,3,1.0
2018-10-14,New York,1,0,1,2,0.75
2018-10-14,Arkansas,2,0,0,2,1.0
2018-10-14,Massachusetts,1,0,0,1,1.0
2018-10-14,Missouri,0,3,0,3,0.0
2018-10-14,Iowa,1,0,0,1,1.0
2018-10-14,Delaware,2,0,0,2,1.0
2018-10-14,Illinois,1,0,0,1,1.0
2018-10-14,Ohio,0,1,0,1,0.0
2018-10-13,Alabama,5,0,0,5,1.0
2018-10-13,California,6,1,0,7,0.8571428571428571
2018-10-13,New York,1,0,0,1,1.0
2018-10-13,Oklahoma,0,1,0,1,0.0
2018-10-13,Nebraska,0,1,0,1,0.0
2018-10-13,Alaska,1,0,0,1,1.0
2018-10-13,Georgia,1,0,0,1,1.0
2018-10-13,Iowa,0,0,1,1,0.5
2018-10-13,Arkansas,2,0,0,2,1.0
2018-10-13,Missouri,3,0,0,3,1.0
2018-10-13,Hawaii,0,0,1,1,0.5
2018-10-13,Indiana,0,1,0,1,0.0
2018-10-13,Delaware,1,0,1,2,0.75
2018-10-12,California,1,0,2,3,0.6666666666666666
2018-10-12,Louisiana,1,0,0,1,1.0
2018-10-12,Alabama,3,2,3,8,0.5625
2018-10-12,Maryland,0,0,1,1,0.5
2018-10-12,Massachusetts,0,0,2,2,0.5
2018-10-12,Ohio,1,0,0,1,1.0
2018-10-12,Washington,0,0,1,1,0.5
2018-10-12,Indiana,1,0,0,1,1.0
2018-10-12,Alaska,1,0,0,1,1.0
2018-10-12,Colorado,1,0,0,1,1.0
2018-10-12,South Carolina,0,1,0,1,0.0
2018-10-12,Delaware,1,0,0,1,1.0
2018-10-12,Georgia,1,0,0,1,1.0
2018-10-12,Hawaii,1,1,3,5,0.5
2018-10-11,California,1,1,1,3,0.5
2018-10-11,Florida,0,1,1,2,0.25
2018-10-11,Connecticut,0,0,1,1,0.5
2018-10-11,Delaware,1,0,0,1,1.0
2018-10-11,Massachusetts,4,1,1,6,0.75
2018-10-11,Alabama,1,0,1,2,0.75
2018-10-11,Washington,2,0,1,3,0.8333333333333333
2018-10-11,Alaska,1,0,0,1,1.0
2018-10-11,New York,0,0,1,1,0.5
2018-10-11,Arkansas,3,0,2,5,0.8
2018-10-11,Illinois,1,0,0,1,1.0
2018-10-11,Indiana,2,0,0,2,1.0
2018-10-11,Maryland,1,0,0,1,1.0
2018-10-11,Hawaii,0,1,0,1,0.0
2018-10-11,Colorado,1,1,0,2,0.5
2018-10-11,Texas,0,2,0,2,0.0
2018-10-10,New York,2,0,2,4,0.75
2018-10-10,California,16,2,0,18,0.8888888888888888
2018-10-10,Missouri,0,1,1,2,0.25
2018-10-10,Texas,1,0,0,1,1.0
2018-10-10,Massachusetts,2,1,2,5,0.6000000000000001
2018-10-10,Alabama,14,4,0,18,0.7777777777777778
2018-10-10,Alaska,2,0,1,3,0.8333333333333333
2018-10-10,Nebraska,2,1,1,4,0.625
2018-10-10,Oregon,1,0,0,1,1.0
2018-10-10,Delaware,1,1,1,3,0.5
2018-10-10,Georgia,1,0,0,1,1.0
2018-10-10,Maine,0,1,0,1,0.0
2018-10-10,Florida,2,0,0,2,1.0
2018-10-10,Hawaii,1,1,0,2,0.5
2018-10-10,Arkansas,2,0,0,2,1.0
2018-10-10,Michigan,1,0,0,1,1.0
2018-10-10,Minnesota,0,1,0,1,0.0
2018-10-10,Iowa,1,0,0,1,1.0
2018-10-10,Illinois,1,0,0,1,1.0
2018-10-10,Colorado,1,0,1,2,0.75
2018-10-10,Connecticut,0,0,2,2,0.5
2018-10-10,South Carolina,0,1,0,1,0.0
2018-10-10,New Jersey,1,0,0,1,1.0
2018-10-09,Alabama,5,3,2,10,0.6
2018-10-09,California,2,1,3,6,0.5833333333333333
2018-10-09,Massachusetts,1,1,4,6,0.5
2018-10-09,Hawaii,4,1,1,6,0.75
2018-10-09,Arkansas,1,0,1,2,0.75
2018-10-09,New York,0,0,1,1,0.5
2018-10-09,Colorado,1,2,1,4,0.375
2018-10-09,Indiana,2,1,1,4,0.625
2018-10-09,Delaware,2,0,0,2,1.0
2018-10-09,Alaska,0,1,0,1,0.0
2018-10-09,Missouri,1,0,0,1,1.0
2018-10-09,Iowa,0,1,1,2,0.25
2018-10-09,Maryland,2,0,0,2,1.0
2018-10-09,Louisiana,1,0,0,1,1.0
2018-10-09,New Jersey,1,0,0,1,1.0
2018-10-09,Florida,1,0,1,2,0.75
2018-10-09,Oregon,1,0,0,1,1.0
2018-10-09,Washington,0,1,0,1,0.0
2018-10-08,Colorado,2,0,1,3,0.8333333333333333
2018-10-08,Alabama,6,1,1,8,0.8125
2018-10-08,Alaska,2,0,1,3,0.8333333333333333
2018-10-08,Kentucky,0,0,1,1,0.5
2018-10-08,New Mexico,1,0,0,1,1.0
2018-10-08,California,3,0,1,4,0.875
2018-10-08,Arkansas,1,0,3,4,0.625
2018-10-08,Delaware,1,0,0,1,1.0
2018-10-08,Georgia,2,1,0,3,0.6666666666666666
2018-10-08,Connecticut,0,1,0,1,0.0
2018-10-08,Nebraska,0,1,1,2,0.25
2018-10-08,New Jersey,1,0,0,1,1.0
2018-10-08,Louisiana,0,0,1,1,0.5
2018-10-08,Oregon,0,2,0,2,0.0
2018-10-08,New York,1,0,0,1,1.0
2018-10-08,Hawaii,2,0,0,2,1.0
2018-10-08,Washington,1,0,0,1,1.0
2018-10-08,Virginia,1,0,0,1,1.0
2018-10-08,Indiana,2,0,0,2,1.0
2018-10-08,Florida,1,0,0,1,1.0
2018-10-08,Michigan,1,0,0,1,1.0
2018-10-08,Kansas,1,0,0,1,1.0
2018-10-08,Ohio,0,0,1,1,0.5
2018-10-07,Arkansas,1,0,0,1,1.0
2018-10-07,Michigan,1,0,0,1,1.0
2018-10-07,Massachusetts,0,0,1,1,0.5
2018-10-07,Colorado,1,0,0,1,1.0
2018-10-07,California,0,1,1,2,0.25
2018-10-07,New Jersey,1,0,0,1,1.0
2018-10-06,Kentucky,1,0,0,1,1.0
2018-10-06,Alabama,1,0,0,1,1.0
2018-10-06,Virginia,2,0,0,2,1.0
2018-10-06,Indiana,3,0,0,3,1.0
2018-10-06,California,3,0,0,3,1.0
2018-10-06,Arkansas,1,4,0,5,0.2
2018-10-06,Louisiana,0,0,1,1,0.5
2018-10-05,Alabama,5,0,0,5,1.0
2018-10-05,Colorado,3,0,0,3,1.0
2018-10-05,Indiana,1,0,1,2,0.75
2018-10-05,Virginia,4,0,0,4,1.0
2018-10-05,Georgia,0,1,0,1,0.0
2018-10-05,California,2,1,1,4,0.625
2018-10-05,Missouri,0,1,0,1,0.0
2018-10-05,Florida,0,0,1,1,0.5
2018-10-05,Massachusetts,0,1,0,1,0.0
2018-10-05,Delaware,1,0,0,1,1.0
2018-10-05,Arkansas,1,1,0,2,0.5
2018-10-05,Washington,4,0,0,4,1.0
2018-10-04,Alabama,4,0,0,4,1.0
2018-10-04,Virginia,3,0,0,3,1.0
2018-10-04,Indiana,3,0,0,3,1.0
2018-10-04,Hawaii,1,0,0,1,1.0
2018-10-04,Colorado,1,0,0,1,1.0
2018-10-04,Texas,1,0,1,2,0.75
2018-10-04,California,2,2,0,4,0.5
2018-10-04,Arkansas,1,0,0,1,1.0
2018-10-04,Louisiana,1,0,0,1,1.0
2018-10-04,New Jersey,1,0,0,1,1.0
2018-10-03,Nebraska,1,0,1,2,0.75
2018-10-03,Virginia,2,0,0,2,1.0
2018-10-03,California,1,0,0,1,1.0
2018-10-03,Indiana,1,0,0,1,1.0
2018-10-03,Texas,1,0,0,1,1.0
2018-10-03,Delaware,1,1,1,3,0.5
2018-10-03,Arizona,0,0,1,1,0.5
2018-10-03,Alabama,1,1,0,2,0.5
2018-10-03,Illinois,1,0,0,1,1.0
2018-10-03,Florida,2,0,0,2,1.0
2018-10-03,Arkansas,0,1,0,1,0.0
2018-10-02,Hawaii,1,0,2,3,0.6666666666666666
2018-10-02,Arkansas,1,5,0,6,0.16666666666666666
2018-10-02,Massachusetts,2,1,0,3,0.6666666666666666
2018-10-02,Colorado,1,0,0,1,1.0
2018-10-02,Virginia,1,0,0,1,1.0
2018-10-02,California,3,0,1,4,0.875
2018-10-02,Delaware,1,0,0,1,1.0
2018-10-02,Florida,1,0,1,2,0.75
2018-10-02,Nebraska,0,1,1,2,0.25
2018-10-02,Indiana,1,0,0,1,1.0
2018-10-02,Missouri,1,0,0,1,1.0
2018-10-01,Virginia,1,0,0,1,1.0
2018-10-01,Washington,0,0,1,1,0.5
2018-10-01,Hawaii,1,0,0,1,1.0
2018-10-01,Georgia,1,0,0,1,1.0
2018-10-01,Illinois,1,0,0,1,1.0
2018-10-01,Alabama,2,0,0,2,1.0
2018-10-01,California,2,0,0,2,1.0
2018-09-30,Alaska,0,1,0,1,0.0
2018-09-30,California,1,0,0,1,1.0
2018-09-30,Washington,2,0,0,2,1.0
2018-09-30,Colorado,1,0,0,1,1.0
2018-09-30,Alabama,2,0,0,2,1.0
2018-09-30,Delaware,0,1,0,1,0.0
2018-09-30,Massachusetts,1,0,0,1,1.0
2018-09-29,California,0,1,1,2,0.25
2018-09-29,Alaska,0,0,1,1,0.5
2018-09-29,Arkansas,1,0,0,1,1.0
2018-09-29,Delaware,1,0,2,3,0.6666666666666666
2018-09-29,Maine,1,0,0,1,1.0
2018-09-29,Indiana,2,0,0,2,1.0
2018-09-29,Maryland,2,0,0,2,1.0
2018-09-29,Massachusetts,1,0,0,1,1.0
2018-09-29,Illinois,1,0,0,1,1.0
2018-09-28,Arkansas,1,3,1,5,0.30000000000000004
2018-09-28,Massachusetts,3,0,1,4,0.875
2018-09-28,Maryland,1,0,0,1,1.0
2018-09-28,Indiana,1,0,0,1,1.0
2018-09-28,Alaska,1,0,0,1,1.0
2018-09-28,New Jersey,0,0,1,1,0.5
2018-09-28,Hawaii,0,0,1,1,0.5
2018-09-28,Minnesota,1,0,0,1,1.0
2018-09-28,Connecticut,0,1,0,1,0.0
2018-09-27,Washington,1,0,0,1,1.0
2018-09-27,Rhode Island,0,0,1,1,0.5
2018-09-27,Massachusetts,3,2,1,6,0.5833333333333334
2018-09-27,Florida,1,0,1,2,0.75
2018-09-27,California,1,1,3,5,0.5
2018-09-27,Colorado,1,0,0,1,1.0
2018-09-27,Alabama,1,0,0,1,1.0
2018-09-26,Massachusetts,4,2,2,8,0.625
2018-09-26,Illinois,1,0,0,1,1.0
2018-09-26,California,0,2,1,3,0.16666666666666666
2018-09-26,Hawaii,1,1,2,4,0.5
2018-09-26,Florida,1,0,1,2,0.75
2018-09-26,Arkansas,1,0,0,1,1.0
2018-09-26,Colorado,1,0,0,1,1.0
2018-09-26,Nebraska,1,0,0,1,1.0
2018-09-26,Indiana,1,0,0,1,1.0
2018-09-25,Louisiana,0,0,1,1,0.5
2018-09-25,Hawaii,0,0,1,1,0.5
2018-09-25,Massachusetts,1,0,5,6,0.5833333333333334
2018-09-25,Alabama,1,1,0,2,0.5
2018-09-25,Maryland,1,0,0,1,1.0
2018-09-25,Nebraska,1,1,0,2,0.5
2018-09-25,Michigan,1,0,0,1,1.0
2018-09-25,Texas,0,0,1,1,0.5
2018-09-25,California,1,0,2,3,0.6666666666666666
2018-09-25,Florida,1,0,0,1,1.0
2018-09-25,Alaska,1,0,0,1,1.0
2018-09-25,Colorado,0,1,0,1,0.0
2018-09-25,Illinois,1,0,0,1,1.0
2018-09-25,Arkansas,0,3,0,3,0.0
2018-09-25,Indiana,1,0,0,1,1.0
2018-09-25,Georgia,1,0,0,1,1.0
2018-09-25,Washington,1,0,0,1,1.0
2018-09-24,Massachusetts,3,1,0,4,0.75
2018-09-24,California,2,1,0,3,0.6666666666666666
2018-09-24,Illinois,1,0,0,1,1.0
2018-09-24,Arkansas,0,1,0,1,0.0
2018-09-24,Georgia,1,0,0,1,1.0
2018-09-24,New York,1,0,0,1,1.0
2018-09-24,Louisiana,1,0,0,1,1.0
2018-09-24,Alabama,1,0,0,1,1.0
2018-09-24,Nebraska,1,0,1,2,0.75
2018-09-24,Delaware,1,0,0,1,1.0
2018-09-23,Alabama,2,0,0,2,1.0
2018-09-23,Massachusetts,1,1,0,2,0.5
2018-09-23,Illinois,0,0,1,1,0.5
2018-09-23,Nebraska,1,0,0,1,1.0
2018-09-23,Arkansas,1,1,1,3,0.5
2018-09-23,Colorado,1,0,0,1,1.0
2018-09-22,Louisiana,1,0,0,1,1.0
2018-09-22,California,3,1,1,5,0.7
2018-09-22,Alaska,1,0,0,1,1.0
2018-09-22,Arkansas,0,1,1,2,0.25
2018-09-22,Florida,1,0,0,1,1.0
2018-09-22,Alabama,2,0,0,2,1.0
2018-09-21,North Carolina,1,0,0,1,1.0
2018-09-21,California,4,0,1,5,0.9
2018-09-21,Arkansas,0,0,1,1,0.5
2018-09-21,Alabama,1,0,0,1,1.0
2018-09-21,Arizona,1,0,0,1,1.0
2018-09-21,Hawaii,2,0,0,2,1.0
2018-09-21,Oregon,0,1,0,1,0.0
2018-09-21,Texas,1,0,0,1,1.0
2018-09-21,New York,0,1,0,1,0.0
2018-09-21,Georgia,0,0,1,1,0.5
2018-09-21,Florida,1,0,0,1,1.0
2018-09-20,Illinois,0,1,1,2,0.25
2018-09-20,Arizona,1,1,0,2,0.5
2018-09-20,Arkansas,0,1,1,2,0.25
2018-09-20,California,2,0,0,2,1.0
2018-09-20,Hawaii,0,0,1,1,0.5
2018-09-20,Nebraska,1,0,0,1,1.0
2018-09-20,Louisiana,2,0,1,3,0.8333333333333333
2018-09-20,Alaska,1,0,0,1,1.0
2018-09-19,Nebraska,0,0,1,1,0.5
2018-09-19,California,4,0,0,4,1.0
2018-09-19,Illinois,1,0,0,1,1.0
2018-09-19,Colorado,1,1,0,2,0.5
2018-09-19,Indiana,0,0,1,1,0.5
2018-09-19,Arkansas,1,0,1,2,0.75
2018-09-19,Massachusetts,2,0,0,2,1.0
2018-09-19,Maryland,0,0,1,1,0.5
2018-09-19,New York,0,0,1,1,0.5
2018-09-19,Alaska,0,1,0,1,0.0
2018-09-18,Arkansas,3,0,0,3,1.0
2018-09-18,California,4,0,0,4,1.0
2018-09-18,Hawaii,1,0,1,2,0.75
2018-09-18,Indiana,1,0,0,1,1.0
2018-09-18,Delaware,0,1,1,2,0.25
2018-09-18,Massachusetts,2,3,2,7,0.42857142857142855
2018-09-18,Florida,1,0,0,1,1.0
2018-09-18,Missouri,2,0,0,2,1.0
2018-09-18,Oregon,0,1,0,1,0.0
2018-09-18,Illinois,1,0,0,1,1.0
2018-09-17,California,4,0,1,5,0.9
2018-09-17,Hawaii,2,2,1,5,0.5
2018-09-17,Massachusetts,4,0,0,4,1.0
2018-09-17,Arkansas,1,0,2,3,0.6666666666666666
2018-09-17,Delaware,0,2,1,3,0.16666666666666666
2018-09-17,Washington,0,0,1,1,0.5
2018-09-17,Nebraska,0,1,0,1,0.0
2018-09-16,Illinois,0,0,2,2,0.5
2018-09-16,California,3,0,0,3,1.0
2018-09-16,Arkansas,4,0,0,4,1.0
2018-09-16,Alabama,1,0,1,2,0.75
2018-09-16,New York,0,0,1,1,0.5
2018-09-16,Missouri,1,1,0,2,0.5
2018-09-16,Arizona,2,0,0,2,1.0
2018-09-16,Oregon,1,1,0,2,0.5
2018-09-16,Delaware,2,0,0,2,1.0
2018-09-16,Washington,0,1,0,1,0.0
2018-09-16,Indiana,0,0,1,1,0.5
2018-09-16,Colorado,1,0,0,1,1.0
2018-09-15,Virginia,3,0,1,4,0.875
2018-09-15,California,8,0,2,10,0.9
2018-09-15,Arkansas,1,1,0,2,0.5
2018-09-15,Florida,2,0,0,2,1.0
2018-09-15,Alabama,0,1,0,1,0.0
2018-09-15,Hawaii,1,0,1,2,0.75
2018-09-15,Louisiana,0,1,0,1,0.0
2018-09-14,Arkansas,1,0,2,3,0.6666666666666666
2018-09-14,Hawaii,3,0,5,8,0.6875
2018-09-14,California,20,2,7,29,0.810344827586207
2018-09-14,New York,2,0,0,2,1.0
2018-09-14,Alabama,3,0,0,3,1.0
2018-09-14,Texas,1,0,0,1,1.0
2018-09-14,Delaware,1,0,0,1,1.0
2018-09-14,Nebraska,0,0,1,1,0.5
2018-09-14,Massachusetts,0,0,1,1,0.5
2018-09-14,Alaska,1,0,0,1,1.0
2018-09-14,Virginia,3,0,1,4,0.875
2018-09-14,Mississippi,1,0,0,1,1.0
2018-09-14,Louisiana,2,0,0,2,1.0
2018-09-14,Colorado,1,0,0,1,1.0
2018-09-14,Florida,1,0,0,1,1.0
2018-09-14,Indiana,2,0,1,3,0.8333333333333333
2018-09-13,Colorado,1,1,1,3,0.5
2018-09-13,California,21,13,14,48,0.5833333333333334
2018-09-13,Arkansas,2,0,3,5,0.7
2018-09-13,Nebraska,1,1,0,2,0.5
2018-09-13,Virginia,7,0,0,7,1.0
2018-09-13,Illinois,0,0,1,1,0.5
2018-09-13,Hawaii,4,0,1,5,0.9
2018-09-13,Alabama,1,1,2,4,0.5
2018-09-13,Massachusetts,1,0,0,1,1.0
2018-09-13,Louisiana,1,0,0,1,1.0
2018-09-13,Florida,2,0,0,2,1.0
2018-09-13,Indiana,1,1,0,2,0.5
2018-09-13,Alaska,4,1,0,5,0.8
2018-09-13,Texas,1,0,0,1,1.0
2018-09-13,Maryland,1,0,1,2,0.75
2018-09-13,New York,1,0,0,1,1.0
2018-09-13,Iowa,1,0,0,1,1.0
2018-09-13,Delaware,1,0,0,1,1.0
2018-09-12,California,44,11,18,73,0.726027397260274
2018-09-12,Massachusetts,3,0,0,3,1.0
2018-09-12,Colorado,3,1,0,4,0.75
2018-09-12,Nebraska,2,0,0,2,1.0
2018-09-12,Florida,2,0,0,2,1.0
2018-09-12,Alaska,4,0,1,5,0.9
2018-09-12,Alabama,4,1,2,7,0.7142857142857142
2018-09-12,New York,4,0,1,5,0.9
2018-09-12,Hawaii,3,0,2,5,0.8
2018-09-12,Indiana,1,1,0,2,0.5
2018-09-12,Virginia,4,0,0,4,1.0
2018-09-12,Washington,1,0,0,1,1.0
2018-09-12,Missouri,1,0,0,1,1.0
2018-09-12,Oklahoma,1,0,0,1,1.0
2018-09-11,California,14,1,4,19,0.8421052631578947
2018-09-11,Alabama,7,1,0,8,0.875
2018-09-11,Georgia,0,0,1,1,0.5
2018-09-11,Florida,2,0,0,2,1.0
2018-09-11,Virginia,1,0,0,1,1.0
2018-09-11,Indiana,2,0,1,3,0.8333333333333333
2018-09-11,Massachusetts,3,1,1,5,0.7
2018-09-11,Illinois,1,0,0,1,1.0
2018-09-11,Arizona,1,1,0,2,0.5
2018-09-11,Hawaii,1,0,0,1,1.0
2018-09-11,Utah,1,0,0,1,1.0
2018-09-11,Idaho,1,0,0,1,1.0
2018-09-11,Louisiana,3,0,0,3,1.0
2018-09-11,Colorado,1,1,0,2,0.5
2018-09-11,Nebraska,0,1,0,1,0.0
2018-09-11,Alaska,0,0,1,1,0.5
2018-09-11,New York,1,0,0,1,1.0
2018-09-10,California,8,2,3,13,0.7307692307692308
2018-09-10,Arkansas,2,1,1,4,0.625
2018-09-10,Illinois,2,1,0,3,0.6666666666666666
2018-09-10,Alabama,2,0,0,2,1.0
2018-09-10,Colorado,1,0,1,2,0.75
2018-09-10,New Jersey,1,0,0,1,1.0
2018-09-10,Hawaii,2,0,0,2,1.0
2018-09-10,Iowa,1,0,0,1,1.0
2018-09-10,Alaska,2,1,0,3,0.6666666666666666
2018-09-10,Michigan,1,0,0,1,1.0
2018-09-10,Florida,1,0,0,1,1.0
2018-09-10,Arizona,3,0,0,3,1.0
2018-09-10,Massachusetts,1,0,0,1,1.0
2018-09-10,Indiana,2,1,0,3,0.6666666666666666
2018-09-10,Nebraska,1,0,0,1,1.0
2018-09-10,New York,0,1,0,1,0.0
2018-09-09,New Jersey,2,0,0,2,1.0
2018-09-09,Hawaii,1,1,0,2,0.5
2018-09-09,California,14,4,4,22,0.7272727272727273
2018-09-09,Delaware,0,0,1,1,0.5
2018-09-09,Massachusetts,1,0,2,3,0.6666666666666666
2018-09-09,Arizona,2,0,1,3,0.8333333333333333
2018-09-09,Oregon,0,0,1,1,0.5
2018-09-09,Colorado,2,1,2,5,0.6000000000000001
2018-09-09,Nebraska,1,1,0,2,0.5
2018-09-09,Missouri,0,0,1,1,0.5
2018-09-09,Indiana,0,0,2,2,0.5
2018-09-09,Arkansas,1,1,0,2,0.5
2018-09-09,Louisiana,2,0,0,2,1.0
2018-09-09,Connecticut,2,0,0,2,1.0
2018-09-09,New York,1,0,1,2,0.75
2018-09-09,Alabama,2,0,1,3,0.8333333333333333
2018-09-09,Alaska,2,0,0,2,1.0
2018-09-09,Florida,0,0,2,2,0.5
2018-09-09,Illinois,1,0,0,1,1.0
2018-09-08,Alabama,9,1,4,14,0.7857142857142858
2018-09-08,Mississippi,1,0,0,1,1.0
2018-09-08,California,85,30,53,168,0.6636904761904762
2018-09-08,Alaska,7,1,4,12,0.75
2018-09-08,Massachusetts,7,6,8,21,0.5238095238095237
2018-09-08,New York,2,2,0,4,0.5
2018-09-08,Arkansas,2,4,8,14,0.42857142857142855
2018-09-08,Illinois,14,7,6,27,0.6296296296296295
2018-09-08,Florida,3,2,0,5,0.6
2018-09-08,Arizona,2,0,0,2,1.0
2018-09-08,Georgia,2,1,2,5,0.6000000000000001
2018-09-08,Iowa,2,1,2,5,0.6000000000000001
2018-09-08,Indiana,9,1,7,17,0.7352941176470589
2018-09-08,Nevada,1,0,0,1,1.0
2018-09-08,New Jersey,2,2,0,4,0.5
2018-09-08,Colorado,2,2,1,5,0.5
2018-09-08,Washington,0,1,0,1,0.0
2018-09-08,Louisiana,4,2,4,10,0.6000000000000001
2018-09-08,Nebraska,2,2,0,4,0.5
2018-09-08,Minnesota,1,0,0,1,1.0
2018-09-08,Missouri,0,0,2,2,0.5
2018-09-08,Kansas,1,0,0,1,1.0
2018-09-08,Hawaii,1,0,0,1,1.0
2018-09-08,Delaware,0,1,0,1,0.0
2018-09-07,California,6,2,2,10,0.7
2018-09-07,Alaska,1,2,0,3,0.3333333333333333
2018-09-07,Alabama,3,1,0,4,0.75
2018-09-07,Delaware,1,0,0,1,1.0
2018-09-07,New York,1,1,2,4,0.5
2018-09-07,Hawaii,2,0,0,2,1.0
2018-09-07,Massachusetts,4,3,6,13,0.5384615384615385
2018-09-07,Nebraska,2,1,0,3,0.6666666666666666
2018-09-07,Indiana,0,0,2,2,0.5
2018-09-07,Pennsylvania,1,0,0,1,1.0
2018-09-07,Arkansas,0,0,1,1,0.5
2018-09-07,Illinois,1,0,0,1,1.0
2018-09-07,Iowa,2,0,0,2,1.0
2018-09-07,Colorado,1,0,0,1,1.0
2018-09-07,Georgia,2,0,1,3,0.8333333333333333
2018-09-07,New Hampshire,1,0,0,1,1.0
2018-09-07,Maryland,1,0,0,1,1.0
2018-09-07,Washington,1,0,0,1,1.0
2018-09-06,Illinois,2,1,1,4,0.625
2018-09-06,Massachusetts,5,1,1,7,0.7857142857142857
2018-09-06,New York,5,3,1,9,0.6111111111111112
2018-09-06,California,4,2,1,7,0.6428571428571428
2018-09-06,Alabama,0,0,1,1,0.5
2018-09-06,Colorado,1,1,1,3,0.5
2018-09-06,Minnesota,1,0,0,1,1.0
2018-09-06,New Jersey,0,0,1,1,0.5
2018-09-06,Indiana,1,0,1,2,0.75
2018-09-06,Louisiana,1,0,0,1,1.0
2018-09-06,Washington,1,0,0,1,1.0
2018-09-05,Illinois,1,1,0,2,0.5
2018-09-05,Indiana,1,0,0,1,1.0
2018-09-05,Alabama,3,1,0,4,0.75
2018-09-05,Arkansas,2,0,1,3,0.8333333333333333
2018-09-05,California,2,1,2,5,0.6000000000000001
2018-09-05,Colorado,1,0,2,3,0.6666666666666666
2018-09-05,Georgia,1,0,0,1,1.0
2018-09-05,New York,2,0,0,2,1.0
2018-09-05,Massachusetts,5,0,0,5,1.0
2018-09-05,Florida,0,1,0,1,0.0
2018-09-05,Washington,2,0,0,2,1.0
2018-09-05,Hawaii,1,0,1,2,0.75
2018-09-05,Delaware,0,1,0,1,0.0
2018-09-05,Alaska,1,0,0,1,1.0
2018-09-04,Illinois,1,0,1,2,0.75
2018-09-04,Alabama,2,0,2,4,0.75
2018-09-04,Colorado,1,0,0,1,1.0
2018-09-04,New York,1,0,0,1,1.0
2018-09-04,California,0,1,2,3,0.3333333333333333
2018-09-04,Louisiana,1,0,1,2,0.75
2018-09-04,Washington,1,1,0,2,0.5
2018-09-04,Hawaii,1,0,1,2,0.75
2018-09-04,Arkansas,1,0,0,1,1.0
2018-09-04,Massachusetts,0,0,1,1,0.5
2018-09-04,Florida,0,0,1,1,0.5
2018-09-04,North Carolina,0,0,1,1,0.5
2018-09-03,Delaware,1,1,0,2,0.5
2018-09-03,Virginia,1,0,0,1,1.0
2018-09-03,Michigan,0,0,1,1,0.5
2018-09-03,Colorado,3,1,0,4,0.75
2018-09-03,Massachusetts,0,0,2,2,0.5
2018-09-03,California,1,0,0,1,1.0
2018-09-03,Hawaii,1,0,0,1,1.0
2018-09-03,New York,0,1,0,1,0.0
2018-09-03,Florida,0,0,2,2,0.5
2018-09-03,Indiana,1,0,0,1,1.0
2018-09-02,Illinois,2,0,0,2,1.0
2018-09-02,Colorado,1,0,0,1,1.0
2018-09-02,New York,0,1,0,1,0.0
2018-09-02,California,1,1,1,3,0.5
2018-09-02,Alabama,0,0,1,1,0.5
2018-09-02,Florida,0,1,0,1,0.0
2018-09-02,Indiana,1,1,1,3,0.5
2018-09-02,Arkansas,0,1,0,1,0.0
2018-09-02,Massachusetts,1,0,0,1,1.0
2018-09-01,California,3,1,0,4,0.75
2018-09-01,Hawaii,2,0,0,2,1.0
2018-09-01,Arkansas,1,0,1,2,0.75
2018-09-01,Delaware,0,0,1,1,0.5
2018-09-01,Nebraska,0,0,1,1,0.5
2018-09-01,Colorado,2,0,1,3,0.8333333333333333
2018-09-01,Connecticut,1,0,0,1,1.0
2018-09-01,Georgia,0,1,0,1,0.0
2018-09-01,Indiana,1,0,0,1,1.0
2018-08-31,Arkansas,3,1,0,4,0.75
2018-08-31,California,4,0,2,6,0.8333333333333333
2018-08-31,Louisiana,1,0,1,2,0.75
2018-08-31,Indiana,1,0,2,3,0.6666666666666666
2018-08-31,Delaware,2,1,0,3,0.6666666666666666
2018-08-31,Florida,1,0,0,1,1.0
2018-08-31,Michigan,0,1,0,1,0.0
2018-08-31,Alabama,2,0,0,2,1.0
2018-08-31,Massachusetts,3,1,0,4,0.75
2018-08-31,Connecticut,0,0,1,1,0.5
2018-08-31,Nebraska,1,0,0,1,1.0
2018-08-31,Illinois,0,1,0,1,0.0
2018-08-31,Texas,1,0,0,1,1.0
2018-08-30,Alabama,0,1,0,1,0.0
2018-08-30,Louisiana,1,0,0,1,1.0
2018-08-30,Nebraska,0,0,1,1,0.5
2018-08-30,Delaware,2,0,0,2,1.0
2018-08-30,Illinois,2,0,0,2,1.0
2018-08-30,Arizona,0,1,0,1,0.0
2018-08-30,Massachusetts,2,0,0,2,1.0
2018-08-30,Indiana,1,0,0,1,1.0
2018-08-30,Connecticut,0,0,1,1,0.5
2018-08-30,California,0,0,2,2,0.5
2018-08-30,Hawaii,1,0,0,1,1.0
2018-08-29,California,8,2,1,11,0.7727272727272727
2018-08-29,Indiana,1,0,1,2,0.75
2018-08-29,Delaware,1,1,0,2,0.5
2018-08-29,Colorado,3,1,2,6,0.6666666666666666
2018-08-29,Hawaii,2,0,2,4,0.75
2018-08-29,Washington,1,0,0,1,1.0
2018-08-29,Alabama,1,0,0,1,1.0
2018-08-29,Massachusetts,2,0,0,2,1.0
2018-08-29,Louisiana,0,0,1,1,0.5
2018-08-29,Arizona,0,0,1,1,0.5
2018-08-29,Georgia,0,0,1,1,0.5
2018-08-29,Arkansas,0,0,1,1,0.5
2018-08-28,Indiana,2,0,0,2,1.0
2018-08-28,California,5,1,5,11,0.6818181818181818
2018-08-28,Ohio,0,0,1,1,0.5
2018-08-28,Nebraska,1,0,0,1,1.0
2018-08-28,Alabama,0,1,0,1,0.0
2018-08-28,Illinois,0,0,1,1,0.5
2018-08-28,New Hampshire,1,0,0,1,1.0
2018-08-28,Colorado,1,0,0,1,1.0
2018-08-28,Iowa,1,0,0,1,1.0
2018-08-28,Arizona,1,0,0,1,1.0
2018-08-27,Arkansas,3,0,1,4,0.875
2018-08-27,Missouri,3,0,0,3,1.0
2018-08-27,Hawaii,1,0,0,1,1.0
2018-08-27,California,1,1,1,3,0.5
2018-08-27,Arizona,1,0,0,1,1.0
2018-08-27,Colorado,4,0,0,4,1.0
2018-08-27,Massachusetts,1,0,1,2,0.75
2018-08-27,Indiana,1,0,0,1,1.0
2018-08-27,Alabama,1,0,0,1,1.0
2018-08-26,Indiana,0,1,0,1,0.0
2018-08-26,California,1,0,1,2,0.75
2018-08-26,Kansas,1,0,0,1,1.0
2018-08-26,Illinois,1,0,0,1,1.0
2018-08-26,Arkansas,1,0,0,1,1.0
2018-08-26,Oregon,0,0,1,1,0.5
2018-08-26,Hawaii,1,0,0,1,1.0
2018-08-26,Florida,1,0,0,1,1.0
2018-08-25,Hawaii,0,0,1,1,0.5
2018-08-25,Massachusetts,1,0,0,1,1.0
2018-08-25,Connecticut,1,0,0,1,1.0
2018-08-25,Alaska,0,0,1,1,0.5
2018-08-25,Georgia,0,0,1,1,0.5
2018-08-25,California,1,0,2,3,0.6666666666666666
2018-08-25,Colorado,1,0,0,1,1.0
2018-08-25,Washington,1,0,0,1,1.0
2018-08-25,Alabama,0,1,0,1,0.0
2018-08-25,Texas,1,0,0,1,1.0
2018-08-24,Florida,0,4,0,4,0.0
2018-08-24,Colorado,2,0,0,2,1.0
2018-08-24,Washington,1,0,0,1,1.0
2018-08-24,Kansas,0,0,1,1,0.5
2018-08-24,Alabama,1,0,1,2,0.75
2018-08-24,California,1,1,3,5,0.5
2018-08-24,Massachusetts,3,0,1,4,0.875
2018-08-24,Louisiana,1,0,0,1,1.0
2018-08-24,Nebraska,1,1,0,2,0.5
2018-08-24,Illinois,1,0,0,1,1.0
2018-08-24,Oregon,1,0,0,1,1.0
2018-08-23,Massachusetts,0,1,0,1,0.0
2018-08-23,New York,1,0,0,1,1.0
2018-08-23,New Hampshire,1,0,1,2,0.75
2018-08-23,California,2,1,0,3,0.6666666666666666
2018-08-23,Georgia,1,0,0,1,1.0
2018-08-23,Hawaii,2,0,0,2,1.0
2018-08-23,Delaware,1,0,0,1,1.0
2018-08-23,Indiana,2,0,0,2,1.0
2018-08-22,Massachusetts,2,1,4,7,0.5714285714285714
2018-08-22,Washington,0,0,1,1,0.5
2018-08-22,Delaware,0,0,1,1,0.5
2018-08-22,California,1,0,2,3,0.6666666666666666
2018-08-22,West Virginia,1,0,0,1,1.0
2018-08-22,Hawaii,1,0,2,3,0.6666666666666666
2018-08-22,Florida,1,0,0,1,1.0
2018-08-22,Indiana,2,0,0,2,1.0
2018-08-22,Arkansas,0,0,1,1,0.5
2018-08-21,Louisiana,1,0,0,1,1.0
2018-08-21,California,3,0,1,4,0.875
2018-08-21,Indiana,1,1,1,3,0.5
2018-08-21,Alaska,0,0,1,1,0.5
2018-08-21,Washington,2,0,1,3,0.8333333333333333
2018-08-21,Alabama,2,0,0,2,1.0
2018-08-21,Colorado,3,1,0,4,0.75
2018-08-21,Massachusetts,1,0,0,1,1.0
2018-08-21,New York,1,0,0,1,1.0
2018-08-21,Illinois,1,0,0,1,1.0
2018-08-21,New Hampshire,1,0,0,1,1.0
2018-08-21,Missouri,1,0,0,1,1.0
2018-08-21,Arkansas,1,0,0,1,1.0
2018-08-21,Georgia,1,0,0,1,1.0
2018-08-21,Arizona,1,0,0,1,1.0
2018-08-21,Florida,0,2,0,2,0.0
2018-08-20,California,2,0,1,3,0.8333333333333333
2018-08-20,Georgia,0,0,1,1,0.5
2018-08-20,Florida,1,0,0,1,1.0
2018-08-20,Colorado,2,0,1,3,0.8333333333333333
2018-08-20,Alabama,1,0,2,3,0.6666666666666666
2018-08-20,Illinois,1,0,0,1,1.0
2018-08-20,Arkansas,0,0,1,1,0.5
2018-08-20,Massachusetts,1,0,0,1,1.0
2018-08-20,Nebraska,1,0,0,1,1.0
2018-08-20,Ohio,0,0,1,1,0.5
2018-08-20,Washington,1,0,0,1,1.0
2018-08-20,Hawaii,1,0,0,1,1.0
2018-08-19,California,1,0,0,1,1.0
2018-08-19,Iowa,0,0,1,1,0.5
2018-08-19,Indiana,0,1,0,1,0.0
2018-08-19,Hawaii,1,0,0,1,1.0
2018-08-19,Maryland,0,1,0,1,0.0
2018-08-19,Alaska,1,0,0,1,1.0
2018-08-19,Nebraska,0,1,0,1,0.0
2018-08-19,Illinois,0,0,1,1,0.5
2018-08-19,Louisiana,0,1,0,1,0.0
2018-08-18,North Dakota,0,0,1,1,0.5
2018-08-18,Colorado,2,0,0,2,1.0
2018-08-18,Florida,1,0,0,1,1.0
2018-08-18,Indiana,1,0,0,1,1.0
2018-08-18,Illinois,0,0,1,1,0.5
2018-08-18,California,0,1,0,1,0.0
2018-08-17,Arkansas,0,0,1,1,0.5
2018-08-17,California,3,2,0,5,0.6
2018-08-17,Connecticut,0,0,1,1,0.5
2018-08-17,Delaware,1,0,0,1,1.0
2018-08-17,Louisiana,0,0,1,1,0.5
2018-08-17,Florida,1,1,0,2,0.5
2018-08-17,Arizona,1,0,0,1,1.0
2018-08-17,Indiana,3,0,0,3,1.0
2018-08-17,Colorado,3,0,0,3,1.0
2018-08-17,Massachusetts,0,0,1,1,0.5
2018-08-17,Washington,1,0,0,1,1.0
2018-08-17,Hawaii,1,0,0,1,1.0
2018-08-17,Alabama,0,1,0,1,0.0
2018-08-16,Alaska,2,0,1,3,0.8333333333333333
2018-08-16,Indiana,2,0,0,2,1.0
2018-08-16,Massachusetts,1,1,0,2,0.5
2018-08-16,Arkansas,1,0,0,1,1.0
2018-08-16,Washington,2,0,0,2,1.0
2018-08-16,Virginia,1,0,0,1,1.0
2018-08-16,New York,1,0,0,1,1.0
2018-08-16,Colorado,2,0,0,2,1.0
2018-08-16,Alabama,1,0,0,1,1.0
2018-08-16,Iowa,1,0,0,1,1.0
2018-08-16,California,1,1,2,4,0.5
2018-08-15,Colorado,1,0,2,3,0.6666666666666666
2018-08-15,Hawaii,0,1,1,2,0.25
2018-08-15,Louisiana,1,0,0,1,1.0
2018-08-15,California,4,0,1,5,0.9
2018-08-15,Arkansas,3,0,0,3,1.0
2018-08-15,Florida,0,1,0,1,0.0
2018-08-15,Washington,0,0,1,1,0.5
2018-08-15,Arizona,1,0,0,1,1.0
2018-08-15,Maryland,1,0,0,1,1.0
2018-08-15,Missouri,1,0,0,1,1.0
2018-08-15,Massachusetts,0,0,1,1,0.5
2018-08-14,Colorado,2,0,1,3,0.8333333333333333
2018-08-14,Arkansas,3,2,0,5,0.6
2018-08-14,Idaho,1,0,0,1,1.0
2018-08-14,California,2,0,0,2,1.0
2018-08-14,Alabama,3,0,0,3,1.0
2018-08-14,Delaware,1,0,0,1,1.0
2018-08-14,Indiana,3,0,0,3,1.0
2018-08-14,Florida,0,0,1,1,0.5
2018-08-14,Georgia,0,1,0,1,0.0
2018-08-13,Arkansas,3,1,0,4,0.75
2018-08-13,Colorado,1,0,1,2,0.75
2018-08-13,California,2,1,0,3,0.6666666666666666
2018-08-13,Washington,2,0,0,2,1.0
2018-08-13,Kentucky,1,0,0,1,1.0
2018-08-13,Massachusetts,0,1,0,1,0.0
2018-08-13,Indiana,1,0,0,1,1.0
2018-08-13,Hawaii,2,0,0,2,1.0
2018-08-13,Arizona,1,0,0,1,1.0
2018-08-12,Hawaii,1,0,2,3,0.6666666666666666
2018-08-12,Arkansas,3,1,0,4,0.75
2018-08-12,Indiana,0,1,1,2,0.25
2018-08-12,Delaware,0,1,0,1,0.0
2018-08-12,Massachusetts,0,1,0,1,0.0
2018-08-12,California,1,0,1,2,0.75
2018-08-12,Alabama,1,0,0,1,1.0
2018-08-12,Georgia,1,0,0,1,1.0
2018-08-11,Louisiana,1,0,0,1,1.0
2018-08-11,California,2,0,2,4,0.75
2018-08-11,Indiana,1,0,0,1,1.0
2018-08-11,Arkansas,2,0,0,2,1.0
2018-08-11,Oregon,0,0,1,1,0.5
2018-08-11,Alabama,1,0,1,2,0.75
2018-08-11,Maine,1,0,0,1,1.0
2018-08-11,Delaware,1,0,0,1,1.0
2018-08-11,New Hampshire,1,0,0,1,1.0
2018-08-11,Washington,3,0,0,3,1.0
2018-08-10,Louisiana,0,0,1,1,0.5
2018-08-10,Georgia,2,0,0,2,1.0
2018-08-10,Delaware,2,1,0,3,0.6666666666666666
2018-08-10,Hawaii,1,1,0,2,0.5
2018-08-10,Oklahoma,1,0,0,1,1.0
2018-08-10,Massachusetts,1,0,0,1,1.0
2018-08-10,California,0,0,1,1,0.5
2018-08-09,California,5,1,4,10,0.7
2018-08-09,Maryland,1,0,0,1,1.0
2018-08-09,Alaska,1,0,0,1,1.0
2018-08-09,Florida,0,2,0,2,0.0
2018-08-09,Michigan,2,0,0,2,1.0
2018-08-09,Illinois,2,0,0,2,1.0
2018-08-09,Alabama,1,0,0,1,1.0
2018-08-09,Idaho,1,0,0,1,1.0
2018-08-08,California,8,6,1,15,0.5666666666666667
2018-08-08,Alabama,3,1,0,4,0.75
2018-08-08,Arkansas,3,0,0,3,1.0
2018-08-08,Colorado,1,0,1,2,0.75
2018-08-08,Florida,1,1,0,2,0.5
2018-08-08,Alaska,6,0,0,6,1.0
2018-08-08,Connecticut,1,0,0,1,1.0
2018-08-08,Massachusetts,3,0,0,3,1.0
2018-08-08,Washington,1,0,0,1,1.0
2018-08-08,Hawaii,1,0,0,1,1.0
2018-08-08,Georgia,1,0,0,1,1.0
2018-08-08,Oregon,1,0,0,1,1.0
2018-08-07,California,4,2,2,8,0.625
2018-08-07,Louisiana,2,0,0,2,1.0
2018-08-07,Colorado,1,0,2,3,0.6666666666666666
2018-08-07,Texas,2,0,0,2,1.0
2018-08-07,Georgia,1,0,0,1,1.0
2018-08-07,Massachusetts,1,0,0,1,1.0
2018-08-07,Indiana,1,0,0,1,1.0
2018-08-07,Nebraska,1,0,0,1,1.0
2018-08-07,North Carolina,1,0,0,1,1.0
2018-08-07,Delaware,1,0,0,1,1.0
2018-08-07,Alabama,1,0,1,2,0.75
2018-08-07,Missouri,2,0,0,2,1.0
2018-08-07,Florida,1,0,0,1,1.0
2018-08-07,Hawaii,1,0,0,1,1.0
2018-08-07,Iowa,1,0,0,1,1.0
2018-08-07,New York,1,0,0,1,1.0
2018-08-07,Connecticut,1,0,0,1,1.0
2018-08-06,Massachusetts,0,1,0,1,0.0
2018-08-06,Indiana,2,0,0,2,1.0
2018-08-06,Nevada,1,0,0,1,1.0
2018-08-06,Connecticut,0,0,1,1,0.5
2018-08-06,Texas,0,0,1,1,0.5
2018-08-06,North Dakota,0,1,0,1,0.0
2018-08-06,Washington,0,0,1,1,0.5
2018-08-06,California,2,1,0,3,0.6666666666666666
2018-08-06,Arizona,1,0,0,1,1.0
2018-08-06,Alabama,1,0,0,1,1.0
2018-08-06,Nebraska,0,0,1,1,0.5
2018-08-05,California,1,2,1,4,0.375
2018-08-05,Louisiana,0,0,1,1,0.5
2018-08-05,Massachusetts,1,0,2,3,0.6666666666666666
2018-08-05,Alabama,1,0,0,1,1.0
2018-08-05,Delaware,1,1,0,2,0.5
2018-08-05,Texas,0,1,0,1,0.0
2018-08-05,Georgia,2,1,0,3,0.6666666666666666
2018-08-05,Indiana,2,0,0,2,1.0
2018-08-05,New Jersey,1,0,0,1,1.0
2018-08-05,Arkansas,1,0,0,1,1.0
2018-08-04,California,3,3,1,7,0.5
2018-08-04,Washington,1,0,0,1,1.0
2018-08-04,Nebraska,1,0,0,1,1.0
2018-08-04,Colorado,2,0,0,2,1.0
2018-08-04,Alabama,3,0,0,3,1.0
2018-08-04,New Jersey,1,0,0,1,1.0
2018-08-04,Illinois,2,0,3,5,0.7
2018-08-04,Louisiana,0,0,1,1,0.5
2018-08-04,Florida,1,0,0,1,1.0
2018-08-04,New York,1,0,0,1,1.0
2018-08-04,Hawaii,0,0,1,1,0.5
2018-08-03,Alabama,2,0,0,2,1.0
2018-08-03,Connecticut,1,0,0,1,1.0
2018-08-03,California,1,0,1,2,0.75
2018-08-03,Indiana,1,0,0,1,1.0
2018-08-03,Massachusetts,1,1,0,2,0.5
2018-08-03,Nevada,0,1,0,1,0.0
2018-08-03,Nebraska,4,0,0,4,1.0
2018-08-03,Louisiana,1,1,3,5,0.5
2018-08-03,Hawaii,0,0,1,1,0.5
2018-08-03,Alaska,1,0,1,2,0.75
2018-08-03,Colorado,1,0,0,1,1.0
2018-08-03,New York,1,0,0,1,1.0
2018-08-03,Washington,2,0,0,2,1.0
2018-08-02,Alaska,0,1,0,1,0.0
2018-08-02,Maryland,0,1,0,1,0.0
2018-08-02,Louisiana,1,1,0,2,0.5
2018-08-02,Colorado,1,0,1,2,0.75
2018-08-02,Alabama,5,1,1,7,0.7857142857142857
2018-08-02,Indiana,1,0,0,1,1.0
2018-08-02,Oregon,1,0,0,1,1.0
2018-08-02,Florida,1,0,2,3,0.6666666666666666
2018-08-02,Texas,1,0,0,1,1.0
2018-08-02,Massachusetts,2,1,1,4,0.625
2018-08-02,Washington,2,0,0,2,1.0
2018-08-02,New Jersey,1,0,0,1,1.0
2018-08-02,California,2,1,0,3,0.6666666666666666
2018-08-02,Arkansas,2,0,0,2,1.0
2018-08-02,Delaware,1,0,0,1,1.0
2018-08-02,Kansas,1,0,0,1,1.0
2018-08-02,Hawaii,0,0,1,1,0.5
2018-08-02,Pennsylvania,1,0,0,1,1.0
2018-08-01,Nevada,2,0,0,2,1.0
2018-08-01,Alabama,26,3,4,33,0.8484848484848484
2018-08-01,Nebraska,0,1,0,1,0.0
2018-08-01,California,2,1,0,3,0.6666666666666666
2018-08-01,Massachusetts,5,4,1,10,0.55
2018-08-01,Hawaii,0,1,0,1,0.0
2018-08-01,Indiana,3,0,0,3,1.0
2018-08-01,Idaho,1,0,0,1,1.0
2018-08-01,Colorado,0,1,0,1,0.0
2018-08-01,Oregon,1,1,0,2,0.5
2018-08-01,New Jersey,1,0,0,1,1.0
2018-08-01,Washington,1,0,0,1,1.0
2018-08-01,Illinois,1,0,0,1,1.0
2018-08-01,Texas,1,0,0,1,1.0
2018-07-31,Georgia,0,0,1,1,0.5
2018-07-31,California,2,0,0,2,1.0
2018-07-31,Alabama,3,0,4,7,0.7142857142857142
2018-07-31,Delaware,0,0,1,1,0.5
2018-07-31,Alaska,1,0,0,1,1.0
2018-07-31,Massachusetts,2,0,0,2,1.0
2018-07-31,Indiana,2,0,0,2,1.0
2018-07-31,Maryland,0,1,0,1,0.0
2018-07-31,Hawaii,0,0,2,2,0.5
2018-07-31,Nebraska,0,0,1,1,0.5
2018-07-31,New Hampshire,1,0,0,1,1.0
2018-07-30,New York,0,0,1,1,0.5
2018-07-30,Alabama,7,0,1,8,0.9375
2018-07-30,Alaska,3,0,0,3,1.0
2018-07-30,Delaware,1,0,1,2,0.75
2018-07-30,Louisiana,1,0,0,1,1.0
2018-07-30,Washington,4,0,0,4,1.0
2018-07-30,Massachusetts,2,0,0,2,1.0
2018-07-30,Mississippi,0,1,0,1,0.0
2018-07-30,California,1,1,0,2,0.5
2018-07-30,Indiana,1,0,0,1,1.0
2018-07-30,Nebraska,1,0,0,1,1.0
2018-07-30,Florida,0,0,1,1,0.5
2018-07-29,Louisiana,1,0,0,1,1.0
2018-07-29,Connecticut,1,0,0,1,1.0
2018-07-29,California,1,0,1,2,0.75
2018-07-29,Alabama,2,1,1,4,0.625
2018-07-29,Michigan,0,1,0,1,0.0
2018-07-29,Texas,2,0,0,2,1.0
2018-07-29,Indiana,0,0,1,1,0.5
2018-07-29,Alaska,1,0,0,1,1.0
2018-07-29,Hawaii,0,0,1,1,0.5
2018-07-29,Idaho,0,0,1,1,0.5
2018-07-29,Kentucky,0,0,1,1,0.5
2018-07-29,Washington,1,0,0,1,1.0
2018-07-29,Colorado,2,0,0,2,1.0
2018-07-29,Arkansas,1,0,0,1,1.0
2018-07-29,Missouri,1,0,0,1,1.0
2018-07-28,Arkansas,1,0,1,2,0.75
2018-07-28,Massachusetts,1,0,0,1,1.0
2018-07-28,Alabama,6,1,2,9,0.7777777777777777
2018-07-28,Louisiana,2,0,0,2,1.0
2018-07-28,Hawaii,1,0,0,1,1.0
2018-07-28,California,2,1,1,4,0.625
2018-07-28,Delaware,0,0,1,1,0.5
2018-07-28,Arizona,1,0,0,1,1.0
2018-07-27,Massachusetts,1,0,2,3,0.6666666666666666
2018-07-27,Oregon,0,1,0,1,0.0
2018-07-27,New Jersey,1,0,0,1,1.0
2018-07-27,Kentucky,0,0,1,1,0.5
2018-07-27,California,2,0,0,2,1.0
2018-07-27,Colorado,1,0,0,1,1.0
2018-07-27,Maine,1,1,0,2,0.5
2018-07-27,Delaware,2,0,0,2,1.0
2018-07-27,New Hampshire,0,0,1,1,0.5
2018-07-27,Pennsylvania,1,0,0,1,1.0
2018-07-27,Maryland,1,0,0,1,1.0
2018-07-27,Alabama,0,0,4,4,0.5
2018-07-27,Arizona,2,0,0,2,1.0
2018-07-27,Georgia,1,0,1,2,0.75
2018-07-27,Michigan,1,0,0,1,1.0
2018-07-26,Massachusetts,2,0,4,6,0.6666666666666666
2018-07-26,Colorado,2,0,0,2,1.0
2018-07-26,Nebraska,1,0,0,1,1.0
2018-07-26,Washington,1,0,0,1,1.0
2018-07-26,Alaska,1,1,0,2,0.5
2018-07-26,Alabama,1,0,4,5,0.6000000000000001
2018-07-26,Maryland,1,0,0,1,1.0
2018-07-26,Georgia,1,0,0,1,1.0
2018-07-26,California,1,0,0,1,1.0
2018-07-26,Arkansas,1,0,0,1,1.0
2018-07-26,Indiana,1,0,0,1,1.0
2018-07-25,Massachusetts,1,1,0,2,0.5
2018-07-25,California,1,0,1,2,0.75
2018-07-25,Washington,1,0,1,2,0.75
2018-07-25,Hawaii,1,0,0,1,1.0
2018-07-25,Indiana,0,0,1,1,0.5
2018-07-25,Arizona,0,0,2,2,0.5
2018-07-25,Connecticut,0,0,1,1,0.5
2018-07-25,Delaware,1,1,0,2,0.5
2018-07-25,New York,1,0,0,1,1.0
2018-07-25,Illinois,1,0,0,1,1.0
2018-07-24,Maryland,1,0,0,1,1.0
2018-07-24,Massachusetts,2,0,1,3,0.8333333333333333
2018-07-24,Nebraska,0,0,1,1,0.5
2018-07-24,California,2,1,3,6,0.5833333333333333
2018-07-24,Delaware,1,0,0,1,1.0
2018-07-24,Alaska,1,0,0,1,1.0
2018-07-24,Arkansas,1,0,0,1,1.0
2018-07-24,Alabama,3,0,0,3,1.0
2018-07-24,New Hampshire,0,2,0,2,0.0
2018-07-24,Virginia,0,1,0,1,0.0
2018-07-24,Indiana,1,0,0,1,1.0
2018-07-24,Illinois,1,0,0,1,1.0
2018-07-24,Missouri,0,0,1,1,0.5
2018-07-24,Hawaii,2,0,0,2,1.0
2018-07-23,Alabama,1,0,1,2,0.75
2018-07-23,Washington,1,0,1,2,0.75
2018-07-23,Arizona,1,0,1,2,0.75
2018-07-23,California,3,0,0,3,1.0
2018-07-23,Arkansas,0,1,0,1,0.0
2018-07-22,Delaware,1,0,0,1,1.0
2018-07-22,Colorado,1,1,0,2,0.5
2018-07-22,Massachusetts,1,1,0,2,0.5
2018-07-22,Nevada,1,0,0,1,1.0
2018-07-22,Maryland,1,0,0,1,1.0
2018-07-22,Washington,1,0,0,1,1.0
2018-07-22,Arizona,0,0,1,1,0.5
2018-07-21,Arkansas,2,1,1,4,0.625
2018-07-21,Hawaii,7,2,1,10,0.75
2018-07-21,California,1,0,0,1,1.0
2018-07-21,Indiana,0,1,0,1,0.0
2018-07-21,Illinois,1,1,0,2,0.5
2018-07-21,Arizona,1,1,0,2,0.5
2018-07-21,Nebraska,0,0,1,1,0.5
2018-07-20,California,4,0,0,4,1.0
2018-07-20,Illinois,1,1,0,2,0.5
2018-07-20,Georgia,1,0,0,1,1.0
2018-07-20,Colorado,2,0,0,2,1.0
2018-07-20,Arkansas,1,0,0,1,1.0
2018-07-20,Alabama,2,0,0,2,1.0
2018-07-20,Florida,0,0,1,1,0.5
2018-07-20,Missouri,1,0,0,1,1.0
2018-07-20,Indiana,1,0,0,1,1.0
2018-07-20,Delaware,1,0,0,1,1.0
2018-07-20,Louisiana,1,0,0,1,1.0
2018-07-19,Washington,4,0,0,4,1.0
2018-07-19,Delaware,4,0,0,4,1.0
2018-07-19,Florida,0,0,1,1,0.5
2018-07-19,Massachusetts,1,2,0,3,0.3333333333333333
2018-07-19,Illinois,1,0,0,1,1.0
2018-07-19,Texas,0,0,1,1,0.5
2018-07-19,Alabama,0,2,1,3,0.16666666666666666
2018-07-19,Colorado,0,0,1,1,0.5
2018-07-19,Hawaii,1,0,1,2,0.75
2018-07-19,Missouri,0,1,0,1,0.0
2018-07-19,Indiana,1,0,0,1,1.0
2018-07-19,California,0,0,1,1,0.5
2018-07-19,Arizona,0,1,0,1,0.0
2018-07-18,California,1,1,0,2,0.5
2018-07-18,Hawaii,1,2,2,5,0.4
2018-07-18,Arizona,2,0,0,2,1.0
2018-07-18,Texas,0,1,0,1,0.0
2018-07-18,Illinois,2,0,0,2,1.0
2018-07-17,Alabama,0,0,1,1,0.5
2018-07-17,Texas,1,0,0,1,1.0
2018-07-17,California,1,0,3,4,0.625
2018-07-17,Missouri,1,0,0,1,1.0
2018-07-16,Hawaii,4,0,1,5,0.9
2018-07-16,Oregon,1,0,0,1,1.0
2018-07-16,Nebraska,1,1,0,2,0.5
2018-07-16,Arizona,1,0,0,1,1.0
2018-07-16,Michigan,1,0,0,1,1.0
2018-07-16,Colorado,1,0,0,1,1.0
2018-07-16,California,2,0,1,3,0.8333333333333333
2018-07-16,Washington,1,0,0,1,1.0
2018-07-16,Alaska,0,0,1,1,0.5
2018-07-15,West Virginia,0,0,1,1,0.5
2018-07-15,Alabama,0,0,2,2,0.5
2018-07-15,Arkansas,1,0,0,1,1.0
2018-07-15,Maine,1,0,0,1,1.0
2018-07-15,Washington,2,0,0,2,1.0
2018-07-15,Hawaii,1,0,0,1,1.0
2018-07-15,Indiana,1,0,0,1,1.0
2018-07-15,New Hampshire,1,0,0,1,1.0
2018-07-15,Minnesota,1,0,0,1,1.0
2018-07-14,Arizona,1,0,0,1,1.0
2018-07-14,Washington,2,0,0,2,1.0
2018-07-14,New York,2,0,0,2,1.0
2018-07-14,Massachusetts,1,0,0,1,1.0
2018-07-14,Louisiana,1,0,0,1,1.0
2018-07-14,North Carolina,1,0,0,1,1.0
2018-07-14,California,1,0,0,1,1.0
2018-07-13,Massachusetts,1,1,0,2,0.5
2018-07-13,Indiana,2,0,0,2,1.0
2018-07-13,Florida,0,1,0,1,0.0
2018-07-13,Washington,1,0,0,1,1.0
2018-07-13,Illinois,1,0,0,1,1.0
2018-07-13,Hawaii,0,1,0,1,0.0
2018-07-13,New York,1,0,1,2,0.75
2018-07-13,Arkansas,1,0,0,1,1.0
2018-07-12,Delaware,0,0,1,1,0.5
2018-07-12,Oregon,0,0,1,1,0.5
2018-07-12,Alaska,1,1,0,2,0.5
2018-07-12,California,1,1,3,5,0.5
2018-07-12,Indiana,2,0,0,2,1.0
2018-07-12,Arizona,1,0,0,1,1.0
2018-07-12,New Hampshire,1,0,0,1,1.0
2018-07-12,Alabama,1,0,0,1,1.0
2018-07-12,Florida,0,1,0,1,0.0
2018-07-11,Colorado,0,1,0,1,0.0
2018-07-11,Hawaii,1,1,0,2,0.5
2018-07-11,Indiana,1,1,0,2,0.5
2018-07-11,Missouri,2,0,0,2,1.0
2018-07-11,Massachusetts,0,0,1,1,0.5
2018-07-11,Alabama,1,0,1,2,0.75
2018-07-11,Oregon,0,1,0,1,0.0
2018-07-11,Delaware,1,0,0,1,1.0
2018-07-10,California,1,2,3,6,0.41666666666666663
2018-07-10,Indiana,0,1,0,1,0.0
2018-07-10,Delaware,0,1,0,1,0.0
2018-07-10,Massachusetts,1,0,1,2,0.75
2018-07-10,Colorado,2,0,0,2,1.0
2018-07-10,Illinois,0,0,1,1,0.5
2018-07-10,New Hampshire,0,1,1,2,0.25
2018-07-10,Georgia,0,0,1,1,0.5
2018-07-09,Alaska,1,0,0,1,1.0
2018-07-09,Oregon,1,0,0,1,1.0
2018-07-09,Alabama,2,0,0,2,1.0
2018-07-09,Massachusetts,3,0,0,3,1.0
2018-07-09,Hawaii,2,0,0,2,1.0
2018-07-09,California,1,0,1,2,0.75
2018-07-09,Indiana,1,0,0,1,1.0
2018-07-09,Louisiana,1,0,2,3,0.6666666666666666
2018-07-09,Colorado,1,0,0,1,1.0
2018-07-09,Delaware,0,1,1,2,0.25
2018-07-09,Nebraska,1,0,0,1,1.0
2018-07-09,Missouri,1,0,0,1,1.0
2018-07-09,Washington,1,0,0,1,1.0
2018-07-08,California,2,1,0,3,0.6666666666666666
2018-07-08,Alaska,0,0,1,1,0.5
2018-07-08,Connecticut,1,0,0,1,1.0
2018-07-08,Delaware,1,0,0,1,1.0
2018-07-08,Arizona,1,0,0,1,1.0
2018-07-08,Nebraska,0,0,1,1,0.5
2018-07-08,Louisiana,0,0,1,1,0.5
2018-07-08,Indiana,1,0,0,1,1.0
2018-07-08,Massachusetts,1,0,0,1,1.0
2018-07-07,Delaware,2,0,1,3,0.8333333333333333
2018-07-07,Louisiana,1,0,0,1,1.0
2018-07-07,California,3,2,1,6,0.5833333333333334
2018-07-07,Alaska,1,0,0,1,1.0
2018-07-07,Massachusetts,1,0,0,1,1.0
2018-07-07,Arizona,1,0,0,1,1.0
2018-07-07,Indiana,2,0,0,2,1.0
2018-07-07,Texas,0,0,1,1,0.5
2018-07-07,Arkansas,1,0,0,1,1.0
2018-07-07,Alabama,2,0,0,2,1.0
2018-07-07,Connecticut,1,0,0,1,1.0
2018-07-07,Hawaii,0,0,1,1,0.5
2018-07-06,Washington,2,1,0,3,0.6666666666666666
2018-07-06,California,4,4,1,9,0.5
2018-07-06,Colorado,1,1,0,2,0.5
2018-07-06,Arizona,2,0,0,2,1.0
2018-07-06,Arkansas,0,0,1,1,0.5
2018-07-06,Alabama,2,0,0,2,1.0
2018-07-06,Alaska,1,1,0,2,0.5
2018-07-06,Nebraska,1,1,0,2,0.5
2018-07-06,Hawaii,0,1,0,1,0.0
2018-07-06,Massachusetts,1,0,0,1,1.0
2018-07-05,Nebraska,1,0,0,1,1.0
2018-07-05,California,3,0,0,3,1.0
2018-07-05,Illinois,1,0,1,2,0.75
2018-07-05,Indiana,4,0,0,4,1.0
2018-07-05,Arkansas,4,0,0,4,1.0
2018-07-05,Alabama,1,0,0,1,1.0
2018-07-05,Arizona,0,0,1,1,0.5
2018-07-05,Colorado,1,0,1,2,0.75
2018-07-05,Massachusetts,1,0,1,2,0.75
2018-07-05,Georgia,1,0,0,1,1.0
2018-07-04,Georgia,1,0,1,2,0.75
2018-07-04,Colorado,1,0,0,1,1.0
2018-07-04,Delaware,0,0,1,1,0.5
2018-07-04,Arkansas,2,0,0,2,1.0
2018-07-04,California,1,0,0,1,1.0
2018-07-03,California,0,0,1,1,0.5
2018-07-03,Florida,1,0,0,1,1.0
2018-07-03,Idaho,1,0,0,1,1.0
2018-07-03,Nebraska,0,0,1,1,0.5
2018-07-03,Georgia,0,0,1,1,0.5
2018-07-03,Arkansas,1,0,0,1,1.0
2018-07-03,Arizona,1,0,0,1,1.0
2018-07-02,Colorado,1,0,0,1,1.0
2018-07-02,Massachusetts,1,1,0,2,0.5
2018-07-02,Florida,1,0,0,1,1.0
2018-07-02,Hawaii,1,0,0,1,1.0
2018-07-02,California,0,0,1,1,0.5
2018-07-02,Oregon,1,0,0,1,1.0
2018-07-02,Missouri,0,0,1,1,0.5
2018-07-02,Delaware,1,0,1,2,0.75
2018-07-01,Arizona,1,0,0,1,1.0
2018-07-01,Georgia,1,0,0,1,1.0
2018-07-01,Connecticut,1,0,0,1,1.0
2018-07-01,New York,0,0,1,1,0.5
2018-07-01,Delaware,1,0,0,1,1.0
2018-07-01,Idaho,0,1,0,1,0.0
2018-06-30,California,2,0,1,3,0.8333333333333333
2018-06-30,Hawaii,1,0,0,1,1.0
2018-06-30,Iowa,0,0,1,1,0.5
2018-06-29,Illinois,0,1,0,1,0.0
2018-06-29,Oregon,0,1,0,1,0.0
2018-06-29,California,1,1,0,2,0.5
2018-06-29,Indiana,2,0,2,4,0.75
2018-06-29,Florida,2,0,0,2,1.0
2018-06-29,Alaska,1,0,0,1,1.0
2018-06-29,Washington,1,0,0,1,1.0
2018-06-29,Massachusetts,1,0,0,1,1.0
2018-06-29,Delaware,1,0,0,1,1.0
2018-06-28,Alabama,2,0,0,2,1.0
2018-06-28,Texas,0,0,2,2,0.5
2018-06-28,Arkansas,1,0,1,2,0.75
2018-06-28,California,0,2,0,2,0.0
2018-06-28,Washington,1,0,0,1,1.0
2018-06-28,Massachusetts,1,0,1,2,0.75
2018-06-28,Hawaii,1,0,0,1,1.0
2018-06-28,Illinois,0,0,3,3,0.5
2018-06-28,Missouri,1,0,0,1,1.0
2018-06-27,California,0,1,1,2,0.25
2018-06-27,Texas,0,0,1,1,0.5
2018-06-27,Arizona,4,0,0,4,1.0
2018-06-27,Massachusetts,1,1,0,2,0.5
2018-06-27,Alabama,0,0,1,1,0.5
2018-06-27,Hawaii,1,0,0,1,1.0
2018-06-27,Colorado,0,0,1,1,0.5
2018-06-26,Illinois,5,0,1,6,0.9166666666666667
2018-06-26,Arkansas,1,0,0,1,1.0
2018-06-26,New York,0,1,0,1,0.0
2018-06-26,Alabama,2,0,1,3,0.8333333333333333
2018-06-26,Delaware,0,0,1,1,0.5
2018-06-26,California,1,0,1,2,0.75
2018-06-26,New Jersey,0,2,0,2,0.0
2018-06-26,Massachusetts,0,2,0,2,0.0
2018-06-26,Georgia,0,1,0,1,0.0
2018-06-26,Arizona,1,0,0,1,1.0
2018-06-26,Hawaii,1,0,0,1,1.0
2018-06-26,Louisiana,1,0,0,1,1.0
2018-06-25,Hawaii,0,0,1,1,0.5
2018-06-25,Delaware,0,1,1,2,0.25
2018-06-25,Washington,1,0,0,1,1.0
2018-06-25,Indiana,1,0,0,1,1.0
2018-06-25,California,1,1,1,3,0.5
2018-06-25,Massachusetts,1,0,0,1,1.0
2018-06-25,Colorado,1,0,0,1,1.0
2018-06-24,Arizona,2,0,0,2,1.0
2018-06-24,Delaware,1,0,0,1,1.0
2018-06-24,Alabama,1,0,0,1,1.0
2018-06-23,California,2,0,0,2,1.0
2018-06-23,Hawaii,1,0,1,2,0.75
2018-06-23,Colorado,2,0,0,2,1.0
2018-06-22,Florida,1,0,1,2,0.75
2018-06-22,Nebraska,1,0,1,2,0.75
2018-06-22,Kentucky,0,1,0,1,0.0
2018-06-22,Missouri,2,0,0,2,1.0
2018-06-22,Massachusetts,1,0,0,1,1.0
2018-06-22,California,0,0,2,2,0.5
2018-06-22,Alabama,3,0,0,3,1.0
2018-06-22,Hawaii,0,0,1,1,0.5
2018-06-22,Louisiana,1,0,0,1,1.0
2018-06-22,Arkansas,1,0,0,1,1.0
2018-06-21,Washington,1,0,0,1,1.0
2018-06-21,Massachusetts,1,0,0,1,1.0
2018-06-21,Alabama,1,0,0,1,1.0
2018-06-21,Hawaii,2,1,0,3,0.6666666666666666
2018-06-21,California,4,1,0,5,0.8
2018-06-21,North Carolina,1,0,0,1,1.0
2018-06-21,Florida,1,0,0,1,1.0
2018-06-21,Louisiana,0,0,1,1,0.5
2018-06-21,Indiana,1,0,1,2,0.75
2018-06-21,Arkansas,1,0,0,1,1.0
2018-06-21,Illinois,0,0,1,1,0.5
2018-06-21,Arizona,0,0,1,1,0.5
2018-06-21,Delaware,0,0,1,1,0.5
2018-06-20,Massachusetts,0,0,1,1,0.5
2018-06-20,California,3,0,0,3,1.0
2018-06-20,Iowa,0,1,0,1,0.0
2018-06-20,Hawaii,1,0,0,1,1.0
2018-06-20,Louisiana,3,0,0,3,1.0
2018-06-20,Connecticut,0,0,1,1,0.5
2018-06-20,Alabama,4,0,0,4,1.0
2018-06-20,Missouri,2,0,0,2,1.0
2018-06-20,Florida,1,0,0,1,1.0
2018-06-20,Indiana,0,0,1,1,0.5
2018-06-19,Alabama,1,0,1,2,0.75
2018-06-19,California,2,0,0,2,1.0
2018-06-19,Massachusetts,1,0,0,1,1.0
2018-06-19,Indiana,1,0,0,1,1.0
2018-06-19,Oregon,1,0,0,1,1.0
2018-06-19,Alaska,0,1,0,1,0.0
2018-06-19,Arkansas,1,0,0,1,1.0
2018-06-18,Massachusetts,5,1,0,6,0.8333333333333334
2018-06-18,Georgia,2,0,0,2,1.0
2018-06-18,California,0,0,2,2,0.5
2018-06-18,Alabama,1,0,0,1,1.0
2018-06-18,Indiana,0,0,1,1,0.5
2018-06-18,Illinois,1,0,0,1,1.0
2018-06-18,Hawaii,1,0,0,1,1.0
2018-06-18,Arkansas,1,0,0,1,1.0
2018-06-17,Hawaii,1,0,0,1,1.0
2018-06-17,New Jersey,1,2,1,4,0.375
2018-06-17,New Hampshire,3,0,0,3,1.0
2018-06-17,Arkansas,1,0,0,1,1.0
2018-06-17,Illinois,1,0,0,1,1.0
2018-06-17,Iowa,1,0,0,1,1.0
2018-06-16,Florida,0,0,1,1,0.5
2018-06-16,Alabama,3,0,0,3,1.0
2018-06-16,New Hampshire,1,0,0,1,1.0
2018-06-16,Massachusetts,0,0,1,1,0.5
2018-06-16,Colorado,1,0,0,1,1.0
2018-06-16,Arkansas,0,1,0,1,0.0
2018-06-16,Hawaii,1,0,0,1,1.0
2018-06-15,New Hampshire,0,1,0,1,0.0
2018-06-15,Louisiana,0,2,0,2,0.0
2018-06-15,Minnesota,2,1,0,3,0.6666666666666666
2018-06-15,Indiana,1,0,0,1,1.0
2018-06-15,Alabama,1,0,1,2,0.75
2018-06-15,Hawaii,1,0,0,1,1.0
2018-06-15,Arkansas,1,0,0,1,1.0
2018-06-15,Colorado,1,0,0,1,1.0
2018-06-15,Massachusetts,1,0,0,1,1.0
2018-06-15,Illinois,0,0,1,1,0.5
2018-06-14,Massachusetts,8,2,0,10,0.8
2018-06-14,California,3,1,1,5,0.7
2018-06-14,New Hampshire,4,0,0,4,1.0
2018-06-14,Hawaii,2,1,1,4,0.625
2018-06-14,Alabama,1,0,0,1,1.0
2018-06-14,Illinois,2,0,0,2,1.0
2018-06-14,Florida,1,0,0,1,1.0
2018-06-14,Indiana,0,0,1,1,0.5
2018-06-14,Arkansas,0,0,1,1,0.5
2018-06-13,Colorado,5,0,1,6,0.9166666666666667
2018-06-13,Arkansas,1,0,0,1,1.0
2018-06-13,Louisiana,2,1,0,3,0.6666666666666666
2018-06-13,Massachusetts,1,0,0,1,1.0
2018-06-13,Indiana,1,0,0,1,1.0
2018-06-13,California,3,0,0,3,1.0
2018-06-13,Alabama,2,0,0,2,1.0
2018-06-12,Hawaii,2,1,1,4,0.625
2018-06-12,Massachusetts,1,1,0,2,0.5
2018-06-12,New Hampshire,1,0,0,1,1.0
2018-06-12,Delaware,1,0,0,1,1.0
2018-06-12,Georgia,1,0,1,2,0.75
2018-06-12,Colorado,1,0,0,1,1.0
2018-06-12,Arkansas,1,0,0,1,1.0
2018-06-12,Arizona,0,0,1,1,0.5
2018-06-12,California,1,0,0,1,1.0
2018-06-12,Alabama,1,0,0,1,1.0
2018-06-11,Hawaii,0,1,1,2,0.25
2018-06-11,California,1,0,1,2,0.75
2018-06-11,Alabama,2,0,0,2,1.0
2018-06-11,Florida,1,1,0,2,0.5
2018-06-11,Arizona,1,0,0,1,1.0
2018-06-10,Florida,1,0,0,1,1.0
2018-06-10,Colorado,1,0,0,1,1.0
2018-06-10,Hawaii,0,1,0,1,0.0
2018-06-10,Alabama,3,0,0,3,1.0
2018-06-10,Massachusetts,0,0,1,1,0.5
2018-06-10,Illinois,0,1,0,1,0.0
2018-06-10,Delaware,0,1,0,1,0.0
2018-06-10,Kansas,0,0,1,1,0.5
2018-06-09,Washington,1,0,0,1,1.0
2018-06-09,Arizona,1,0,1,2,0.75
2018-06-09,Colorado,1,0,0,1,1.0
2018-06-09,Delaware,1,0,0,1,1.0
2018-06-08,Georgia,1,0,1,2,0.75
2018-06-08,Kansas,1,0,0,1,1.0
2018-06-08,California,2,0,0,2,1.0
2018-06-08,Louisiana,1,0,0,1,1.0
2018-06-08,Massachusetts,1,0,2,3,0.6666666666666666
2018-06-08,Alabama,1,0,3,4,0.625
2018-06-08,Virginia,1,0,0,1,1.0
2018-06-08,Hawaii,2,0,0,2,1.0
2018-06-08,Arizona,1,0,0,1,1.0
2018-06-07,Florida,1,0,1,2,0.75
2018-06-07,Alaska,1,0,0,1,1.0
2018-06-07,Hawaii,3,0,0,3,1.0
2018-06-07,Oregon,0,0,1,1,0.5
2018-06-07,Massachusetts,0,0,1,1,0.5
2018-06-07,Indiana,0,0,1,1,0.5
2018-06-07,Arizona,1,0,0,1,1.0
2018-06-06,Hawaii,4,1,4,9,0.6666666666666666
2018-06-06,Texas,0,0,1,1,0.5
2018-06-06,Alabama,3,0,2,5,0.8
2018-06-06,Indiana,1,1,1,3,0.5
2018-06-06,Delaware,1,0,0,1,1.0
2018-06-06,Illinois,1,0,0,1,1.0
2018-06-05,Washington,0,1,0,1,0.0
2018-06-05,Alabama,1,0,5,6,0.5833333333333334
2018-06-05,Georgia,0,1,0,1,0.0
2018-06-05,California,2,2,0,4,0.5
2018-06-05,Indiana,2,0,0,2,1.0
2018-06-05,Hawaii,3,0,1,4,0.875
2018-06-05,Texas,1,0,0,1,1.0
2018-06-05,Illinois,1,0,0,1,1.0
2018-06-05,Arizona,1,0,0,1,1.0
2018-06-05,Massachusetts,1,0,0,1,1.0
2018-06-04,Missouri,4,2,2,8,0.625
2018-06-04,California,2,0,0,2,1.0
2018-06-04,Alabama,0,0,2,2,0.5
2018-06-04,Colorado,1,0,1,2,0.75
2018-06-04,Hawaii,4,0,1,5,0.9
2018-06-04,Louisiana,1,0,0,1,1.0
2018-06-03,Alabama,2,1,1,4,0.625
2018-06-03,Georgia,2,0,0,2,1.0
2018-06-03,California,1,1,0,2,0.5
2018-06-03,Arkansas,2,0,0,2,1.0
2018-06-03,Massachusetts,1,0,0,1,1.0
2018-06-03,New Hampshire,1,0,0,1,1.0
2018-06-03,Virginia,1,0,0,1,1.0
2018-06-03,Nebraska,1,0,0,1,1.0
2018-06-03,Illinois,0,0,1,1,0.5
2018-06-03,Hawaii,1,0,0,1,1.0
2018-06-03,Indiana,1,0,0,1,1.0
2018-06-03,Colorado,1,0,0,1,1.0
2018-06-03,Iowa,1,1,0,2,0.5
2018-06-03,Maryland,0,1,0,1,0.0
2018-06-02,Illinois,0,0,1,1,0.5
2018-06-02,Michigan,0,1,0,1,0.0
2018-06-02,Arizona,3,0,0,3,1.0
2018-06-02,Alabama,0,0,2,2,0.5
2018-06-02,Indiana,0,0,1,1,0.5
2018-06-02,California,1,0,0,1,1.0
2018-06-02,Nebraska,1,0,0,1,1.0
2018-06-02,New Hampshire,1,0,0,1,1.0
2018-06-01,Massachusetts,2,0,2,4,0.75
2018-06-01,Alabama,1,0,1,2,0.75
2018-06-01,Alaska,3,0,0,3,1.0
2018-06-01,California,0,1,0,1,0.0
2018-06-01,Connecticut,1,0,0,1,1.0
2018-06-01,Indiana,2,0,1,3,0.8333333333333333
2018-06-01,Colorado,0,0,1,1,0.5
2018-06-01,Hawaii,0,1,0,1,0.0
2018-06-01,New York,1,0,0,1,1.0
2018-06-01,Kentucky,1,0,0,1,1.0
2018-05-31,Alabama,1,0,0,1,1.0
2018-05-31,Indiana,0,0,1,1,0.5
2018-05-31,Massachusetts,1,0,0,1,1.0
2018-05-31,Arkansas,1,0,0,1,1.0
2018-05-31,Illinois,2,0,0,2,1.0
2018-05-31,Hawaii,0,1,0,1,0.0
2018-05-31,Arizona,1,0,0,1,1.0
2018-05-31,Florida,1,0,0,1,1.0
2018-05-31,California,1,0,0,1,1.0
2018-05-30,Alabama,7,1,1,9,0.8333333333333334
2018-05-30,Alaska,1,0,0,1,1.0
2018-05-30,Colorado,0,0,1,1,0.5
2018-05-30,Massachusetts,2,0,1,3,0.8333333333333333
2018-05-30,Washington,1,0,0,1,1.0
2018-05-30,Arkansas,0,1,0,1,0.0
2018-05-30,Louisiana,1,0,0,1,1.0
2018-05-30,Hawaii,0,0,1,1,0.5
2018-05-30,Delaware,3,0,0,3,1.0
2018-05-29,New Hampshire,1,0,0,1,1.0
2018-05-29,Arkansas,1,0,0,1,1.0
2018-05-29,Alabama,1,0,0,1,1.0
2018-05-29,Washington,1,0,0,1,1.0
2018-05-29,Indiana,0,0,1,1,0.5
2018-05-29,California,1,0,1,2,0.75
2018-05-28,Hawaii,2,0,0,2,1.0
2018-05-28,New York,1,0,0,1,1.0
2018-05-28,Delaware,0,1,1,2,0.25
2018-05-28,Virginia,1,0,0,1,1.0
2018-05-28,Nebraska,0,1,0,1,0.0
2018-05-28,Alabama,3,0,0,3,1.0
2018-05-28,Arkansas,0,0,1,1,0.5
2018-05-27,Florida,1,0,1,2,0.75
2018-05-27,Alaska,1,0,0,1,1.0
2018-05-27,Alabama,2,0,0,2,1.0
2018-05-27,Iowa,0,0,1,1,0.5
2018-05-27,Colorado,0,1,0,1,0.0
2018-05-27,Ohio,1,0,0,1,1.0
2018-05-27,Louisiana,1,0,0,1,1.0
2018-05-26,Arizona,1,0,0,1,1.0
2018-05-26,Idaho,1,0,0,1,1.0
2018-05-26,California,1,0,0,1,1.0
2018-05-26,Alaska,1,0,0,1,1.0
2018-05-26,Delaware,1,0,0,1,1.0
2018-05-26,Colorado,1,1,0,2,0.5
2018-05-25,California,3,0,0,3,1.0
2018-05-24,California,1,0,0,1,1.0
2018-05-24,Minnesota,0,0,1,1,0.5
2018-05-24,Georgia,0,0,1,1,0.5
2018-05-24,Massachusetts,1,2,0,3,0.3333333333333333
2018-05-24,Louisiana,2,0,0,2,1.0
2018-05-24,Alabama,1,0,0,1,1.0
2018-05-24,Kentucky,0,1,0,1,0.0
2018-05-24,Nebraska,0,1,0,1,0.0
2018-05-24,Hawaii,1,0,0,1,1.0
2018-05-24,Missouri,0,0,1,1,0.5
2018-05-23,Illinois,1,1,0,2,0.5
2018-05-23,Colorado,1,0,1,2,0.75
2018-05-23,Alabama,1,0,0,1,1.0
2018-05-23,Arizona,1,0,0,1,1.0
2018-05-23,Oregon,0,1,0,1,0.0
2018-05-23,Massachusetts,1,0,0,1,1.0
2018-05-23,Louisiana,1,0,0,1,1.0
2018-05-22,Washington,1,0,0,1,1.0
2018-05-22,Alaska,1,0,0,1,1.0
2018-05-22,Indiana,0,1,0,1,0.0
2018-05-22,California,1,0,2,3,0.6666666666666666
2018-05-22,Hawaii,1,0,0,1,1.0
2018-05-22,Illinois,1,0,0,1,1.0
2018-05-22,Massachusetts,0,0,2,2,0.5
2018-05-22,Louisiana,2,0,0,2,1.0
2018-05-22,Alabama,1,0,0,1,1.0
2018-05-21,Indiana,1,0,0,1,1.0
2018-05-21,Massachusetts,0,0,1,1,0.5
2018-05-21,Illinois,1,0,0,1,1.0
2018-05-21,New York,4,0,0,4,1.0
2018-05-21,Hawaii,2,0,0,2,1.0
2018-05-21,Arizona,1,0,0,1,1.0
2018-05-20,Virginia,0,0,1,1,0.5
2018-05-20,New York,1,0,0,1,1.0
2018-05-20,Indiana,0,1,0,1,0.0
2018-05-20,Massachusetts,1,0,0,1,1.0
2018-05-20,California,1,0,0,1,1.0
2018-05-19,California,0,0,1,1,0.5
2018-05-19,Alabama,1,0,1,2,0.75
2018-05-19,Hawaii,2,0,0,2,1.0
2018-05-19,Florida,1,0,0,1,1.0
2018-05-19,Washington,1,0,0,1,1.0
2018-05-19,Colorado,1,0,0,1,1.0
2018-05-18,Massachusetts,1,0,0,1,1.0
2018-05-18,California,2,1,0,3,0.6666666666666666
2018-05-18,Hawaii,1,0,0,1,1.0
2018-05-18,Florida,1,0,0,1,1.0
2018-05-18,Delaware,2,0,0,2,1.0
2018-05-18,Oregon,2,0,0,2,1.0
2018-05-18,Virginia,1,0,0,1,1.0
2018-05-18,Alaska,1,0,0,1,1.0
2018-05-18,Colorado,1,0,0,1,1.0
2018-05-18,Arkansas,0,0,1,1,0.5
2018-05-18,Georgia,1,0,0,1,1.0
2018-05-18,New York,1,0,0,1,1.0
2018-05-17,New York,2,1,1,4,0.625
2018-05-17,Colorado,1,0,1,2,0.75
2018-05-17,Michigan,1,0,0,1,1.0
2018-05-17,Massachusetts,0,1,0,1,0.0
2018-05-17,California,3,1,2,6,0.6666666666666666
2018-05-17,Hawaii,1,0,0,1,1.0
2018-05-17,Missouri,1,0,0,1,1.0
2018-05-17,Arizona,1,0,0,1,1.0
2018-05-17,Indiana,1,0,1,2,0.75
2018-05-17,Delaware,1,0,0,1,1.0
2018-05-17,Oklahoma,0,1,0,1,0.0
2018-05-17,Washington,0,0,1,1,0.5
2018-05-17,Louisiana,1,0,0,1,1.0
2018-05-17,Iowa,1,0,0,1,1.0
2018-05-17,Georgia,1,0,0,1,1.0
2018-05-16,Indiana,1,0,1,2,0.75
2018-05-16,California,1,2,0,3,0.3333333333333333
2018-05-16,Kentucky,0,1,0,1,0.0
2018-05-16,Washington,0,1,0,1,0.0
2018-05-16,Arkansas,0,0,1,1,0.5
2018-05-16,Alaska,1,0,0,1,1.0
2018-05-16,Alabama,0,0,1,1,0.5
2018-05-16,Illinois,2,0,0,2,1.0
2018-05-16,Arizona,0,0,1,1,0.5
2018-05-16,Hawaii,1,1,0,2,0.5
2018-05-15,Virginia,0,1,0,1,0.0
2018-05-15,Louisiana,2,0,0,2,1.0
2018-05-15,Hawaii,1,0,1,2,0.75
2018-05-15,Indiana,2,0,0,2,1.0
2018-05-15,California,2,0,0,2,1.0
2018-05-14,Hawaii,2,1,0,3,0.6666666666666666
2018-05-14,Texas,0,1,0,1,0.0
2018-05-14,Alaska,0,1,0,1,0.0
2018-05-14,Arkansas,0,0,1,1,0.5
2018-05-14,Louisiana,0,0,1,1,0.5
2018-05-14,Virginia,1,0,0,1,1.0
2018-05-14,Indiana,1,0,0,1,1.0
2018-05-14,California,1,0,1,2,0.75
2018-05-14,Florida,1,0,0,1,1.0
2018-05-14,Washington,1,0,0,1,1.0
2018-05-14,Colorado,0,1,0,1,0.0
2018-05-13,Arkansas,1,0,0,1,1.0
2018-05-13,Colorado,1,0,0,1,1.0
2018-05-13,California,1,0,0,1,1.0
2018-05-13,Arizona,0,1,0,1,0.0
2018-05-12,New York,2,1,0,3,0.6666666666666666
2018-05-12,Arkansas,1,0,0,1,1.0
2018-05-12,Delaware,0,1,0,1,0.0
2018-05-12,Illinois,0,2,0,2,0.0
2018-05-12,Texas,0,0,1,1,0.5
2018-05-12,Alabama,0,3,0,3,0.0
2018-05-12,Nebraska,1,0,0,1,1.0
2018-05-11,Arkansas,1,0,0,1,1.0
2018-05-11,California,1,1,1,3,0.5
2018-05-11,Virginia,2,0,0,2,1.0
2018-05-11,Illinois,0,0,1,1,0.5
2018-05-11,Indiana,1,0,0,1,1.0
2018-05-11,New York,0,0,1,1,0.5
2018-05-11,Connecticut,1,0,0,1,1.0
2018-05-10,Alabama,4,1,0,5,0.8
2018-05-10,Nebraska,1,1,0,2,0.5
2018-05-10,Washington,0,0,1,1,0.5
2018-05-10,Hawaii,2,0,1,3,0.8333333333333333
2018-05-10,California,1,0,0,1,1.0
2018-05-10,Florida,2,0,0,2,1.0
2018-05-10,Indiana,2,0,0,2,1.0
2018-05-10,Massachusetts,0,0,1,1,0.5
2018-05-10,Louisiana,0,0,1,1,0.5
2018-05-10,Illinois,1,0,0,1,1.0
2018-05-10,Delaware,1,0,0,1,1.0
2018-05-09,Alaska,0,1,0,1,0.0
2018-05-09,Arkansas,2,0,0,2,1.0
2018-05-09,New York,0,0,1,1,0.5
2018-05-09,Indiana,0,0,2,2,0.5
2018-05-09,California,1,0,0,1,1.0
2018-05-09,Hawaii,0,0,2,2,0.5
2018-05-09,Massachusetts,0,0,1,1,0.5
2018-05-09,Washington,2,1,0,3,0.6666666666666666
2018-05-09,Florida,1,0,0,1,1.0
2018-05-08,California,3,2,1,6,0.5833333333333334
2018-05-08,Alabama,4,0,1,5,0.9
2018-05-08,Arkansas,1,0,0,1,1.0
2018-05-08,Massachusetts,1,0,0,1,1.0
2018-05-08,Iowa,0,0,1,1,0.5
2018-05-08,Hawaii,2,0,1,3,0.8333333333333333
2018-05-08,Indiana,1,0,0,1,1.0
2018-05-08,North Carolina,0,1,0,1,0.0
2018-05-08,Maine,1,0,0,1,1.0
2018-05-08,Florida,1,0,0,1,1.0
2018-05-08,Illinois,2,0,0,2,1.0
2018-05-08,Arizona,1,0,0,1,1.0
2018-05-08,Georgia,1,0,0,1,1.0
2018-05-08,Colorado,0,1,0,1,0.0
2018-05-07,Colorado,0,0,1,1,0.5
2018-05-07,Washington,1,0,0,1,1.0
2018-05-07,Massachusetts,1,0,0,1,1.0
2018-05-07,Alabama,1,1,0,2,0.5
2018-05-07,Arizona,0,1,0,1,0.0
2018-05-06,Michigan,1,0,0,1,1.0
2018-05-06,Arkansas,0,0,1,1,0.5
2018-05-06,Arizona,1,0,0,1,1.0
2018-05-06,Florida,1,0,0,1,1.0
2018-05-06,Oregon,0,0,1,1,0.5
2018-05-06,California,1,0,0,1,1.0
2018-05-05,New York,0,0,1,1,0.5
2018-05-05,Indiana,1,0,0,1,1.0
2018-05-05,California,3,0,0,3,1.0
2018-05-05,Florida,1,0,0,1,1.0
2018-05-05,Massachusetts,2,0,1,3,0.8333333333333333
2018-05-04,Alabama,1,1,0,2,0.5
2018-05-04,Minnesota,0,0,1,1,0.5
2018-05-04,Massachusetts,1,0,1,2,0.75
2018-05-04,Illinois,1,0,0,1,1.0
2018-05-04,California,0,1,0,1,0.0
2018-05-04,Arizona,1,0,0,1,1.0
2018-05-04,Colorado,0,1,0,1,0.0
2018-05-03,New York,0,1,0,1,0.0
2018-05-03,Massachusetts,0,0,1,1,0.5
2018-05-03,Alabama,2,0,0,2,1.0
2018-05-03,Oklahoma,0,1,0,1,0.0
2018-05-03,Indiana,0,0,1,1,0.5
2018-05-03,Illinois,0,0,1,1,0.5
2018-05-03,Idaho,1,0,0,1,1.0
2018-05-03,Nebraska,1,0,0,1,1.0
2018-05-03,Missouri,0,0,1,1,0.5
2018-05-03,Arkansas,1,0,1,2,0.75
2018-05-03,Washington,1,0,0,1,1.0
2018-05-02,California,0,1,1,2,0.25
2018-05-02,Maine,2,0,0,2,1.0
2018-05-02,Washington,1,0,0,1,1.0
2018-05-02,Arizona,1,0,0,1,1.0
2018-05-02,Indiana,0,1,1,2,0.25
2018-05-02,Alabama,1,0,1,2,0.75
2018-05-02,Massachusetts,1,0,0,1,1.0
2018-05-01,Louisiana,2,1,0,3,0.6666666666666666
2018-05-01,Hawaii,0,0,1,1,0.5
2018-05-01,New Jersey,0,0,1,1,0.5
2018-05-01,Nebraska,0,1,1,2,0.25
2018-05-01,California,2,0,0,2,1.0
2018-05-01,Florida,0,0,1,1,0.5
2018-05-01,Georgia,1,0,0,1,1.0
2018-05-01,Arkansas,3,0,1,4,0.875
2018-05-01,Iowa,0,0,1,1,0.5
2018-05-01,Alabama,0,0,1,1,0.5
2018-05-01,Illinois,0,0,2,2,0.5
2018-04-30,California,3,0,0,3,1.0
2018-04-30,Iowa,1,0,0,1,1.0
2018-04-30,Arizona,0,0,1,1,0.5
2018-04-30,Maine,1,0,0,1,1.0
2018-04-30,New Jersey,1,0,0,1,1.0
2018-04-30,Delaware,0,1,1,2,0.25
2018-04-30,Virginia,1,0,0,1,1.0
2018-04-30,Texas,1,0,0,1,1.0
2018-04-30,Alabama,1,0,0,1,1.0
2018-04-30,Illinois,1,0,0,1,1.0
2018-04-29,California,2,0,0,2,1.0
2018-04-29,Nebraska,1,0,0,1,1.0
2018-04-29,Minnesota,0,0,1,1,0.5
2018-04-29,Alabama,0,1,0,1,0.0
2018-04-29,Illinois,1,0,0,1,1.0
2018-04-29,Massachusetts,0,1,0,1,0.0
2018-04-29,Florida,1,0,0,1,1.0
2018-04-28,Indiana,0,0,1,1,0.5
2018-04-28,Nebraska,1,0,0,1,1.0
2018-04-28,Arkansas,1,0,0,1,1.0
2018-04-28,Connecticut,0,0,1,1,0.5
2018-04-28,Alabama,1,0,0,1,1.0
2018-04-27,California,1,1,0,2,0.5
2018-04-27,Georgia,1,0,0,1,1.0
2018-04-27,Minnesota,0,1,0,1,0.0
2018-04-27,Massachusetts,2,0,1,3,0.8333333333333333
2018-04-27,Alaska,0,1,0,1,0.0
2018-04-27,Washington,1,1,0,2,0.5
2018-04-27,New York,1,0,0,1,1.0
2018-04-27,Alabama,0,1,0,1,0.0
2018-04-27,Hawaii,0,1,0,1,0.0
2018-04-27,Illinois,0,1,0,1,0.0
2018-04-27,Missouri,1,0,0,1,1.0
2018-04-27,Louisiana,1,0,0,1,1.0
2018-04-26,Arkansas,1,1,0,2,0.5
2018-04-26,Indiana,2,0,1,3,0.8333333333333333
2018-04-26,Alabama,2,0,0,2,1.0
2018-04-26,Delaware,2,0,1,3,0.8333333333333333
2018-04-26,Massachusetts,1,1,0,2,0.5
2018-04-26,Virginia,1,0,1,2,0.75
2018-04-26,California,2,1,0,3,0.6666666666666666
2018-04-26,Arizona,1,0,0,1,1.0
2018-04-26,Washington,1,0,1,2,0.75
2018-04-26,Illinois,1,0,0,1,1.0
2018-04-26,New York,1,0,1,2,0.75
2018-04-26,Hawaii,0,0,1,1,0.5
2018-04-26,Texas,0,0,1,1,0.5
2018-04-26,Nebraska,0,0,1,1,0.5
2018-04-25,Delaware,0,0,1,1,0.5
2018-04-25,Massachusetts,3,0,0,3,1.0
2018-04-25,Washington,1,0,0,1,1.0
2018-04-25,Hawaii,3,0,0,3,1.0
2018-04-25,Indiana,2,0,1,3,0.8333333333333333
2018-04-25,California,0,1,1,2,0.25
2018-04-25,Oregon,13,1,1,15,0.9
2018-04-25,Minnesota,1,0,0,1,1.0
2018-04-25,Alabama,0,0,1,1,0.5
2018-04-25,New York,1,0,0,1,1.0
2018-04-25,Nebraska,2,0,0,2,1.0
2018-04-25,Colorado,1,0,0,1,1.0
2018-04-24,California,3,0,0,3,1.0
2018-04-24,Washington,1,0,1,2,0.75
2018-04-24,Indiana,1,0,0,1,1.0
2018-04-24,Alabama,1,0,0,1,1.0
2018-04-24,Florida,1,1,0,2,0.5
2018-04-24,Colorado,0,0,1,1,0.5
2018-04-24,Arkansas,0,0,1,1,0.5
2018-04-24,Hawaii,0,0,2,2,0.5
2018-04-24,Arizona,1,0,0,1,1.0
2018-04-24,Illinois,0,0,1,1,0.5
2018-04-24,Minnesota,1,0,0,1,1.0
2018-04-24,Massachusetts,0,0,1,1,0.5
2018-04-23,Alabama,0,1,2,3,0.3333333333333333
2018-04-23,Arkansas,2,0,0,2,1.0
2018-04-23,Indiana,3,0,0,3,1.0
2018-04-23,California,2,1,2,5,0.6000000000000001
2018-04-23,Massachusetts,2,2,0,4,0.5
2018-04-23,Louisiana,0,0,1,1,0.5
2018-04-23,Illinois,1,1,1,3,0.5
2018-04-23,New York,1,0,1,2,0.75
2018-04-23,Florida,0,0,1,1,0.5
2018-04-23,Arizona,1,0,0,1,1.0
2018-04-22,Wisconsin,0,0,1,1,0.5
2018-04-22,Washington,0,0,1,1,0.5
2018-04-22,Arkansas,6,1,5,12,0.7083333333333334
2018-04-22,Arizona,1,1,0,2,0.5
2018-04-22,Iowa,0,0,1,1,0.5
2018-04-22,Massachusetts,0,0,1,1,0.5
2018-04-22,Alabama,3,2,1,6,0.5833333333333334
2018-04-22,California,4,2,2,8,0.625
2018-04-22,Indiana,2,0,1,3,0.8333333333333333
2018-04-22,Connecticut,1,0,0,1,1.0
2018-04-22,Illinois,3,0,1,4,0.875
2018-04-22,Florida,3,0,0,3,1.0
2018-04-22,Missouri,1,0,0,1,1.0
2018-04-22,Georgia,1,0,1,2,0.75
2018-04-22,Hawaii,0,0,1,1,0.5
2018-04-22,New York,1,0,0,1,1.0
2018-04-22,Louisiana,1,0,0,1,1.0
2018-04-22,Nebraska,1,0,0,1,1.0
2018-04-22,Michigan,1,0,0,1,1.0
2018-04-22,New Mexico,1,0,0,1,1.0
2018-04-22,Delaware,2,0,0,2,1.0
2018-04-22,Maine,1,0,0,1,1.0
2018-04-21,Colorado,3,0,0,3,1.0
2018-04-21,Massachusetts,0,1,0,1,0.0
2018-04-21,Alabama,5,0,0,5,1.0
2018-04-21,Indiana,1,0,0,1,1.0
2018-04-21,Maine,0,1,0,1,0.0
2018-04-21,California,3,2,1,6,0.5833333333333334
2018-04-21,Illinois,1,0,0,1,1.0
2018-04-21,Hawaii,0,1,0,1,0.0
2018-04-21,New York,1,0,0,1,1.0
2018-04-21,Arkansas,1,0,0,1,1.0
2018-04-21,Iowa,1,0,0,1,1.0
2018-04-21,Florida,1,0,0,1,1.0
2018-04-21,Connecticut,0,0,1,1,0.5
2018-04-20,Nebraska,2,1,0,3,0.6666666666666666
2018-04-20,California,6,1,0,7,0.8571428571428571
2018-04-20,Connecticut,1,0,0,1,1.0
2018-04-20,Alaska,0,0,1,1,0.5
2018-04-20,Illinois,1,0,0,1,1.0
2018-04-20,Hawaii,4,0,1,5,0.9
2018-04-20,Arizona,2,0,0,2,1.0
2018-04-20,New York,0,0,1,1,0.5
2018-04-20,Massachusetts,1,0,0,1,1.0
2018-04-20,Alabama,1,0,0,1,1.0
2018-04-20,Arkansas,1,0,0,1,1.0
2018-04-20,Texas,0,1,0,1,0.0
2018-04-19,Alabama,1,0,0,1,1.0
2018-04-19,Indiana,1,1,0,2,0.5
2018-04-19,California,4,1,4,9,0.6666666666666666
2018-04-19,Hawaii,6,1,0,7,0.8571428571428571
2018-04-19,Arizona,0,0,1,1,0.5
2018-04-19,Arkansas,0,2,0,2,0.0
2018-04-19,Massachusetts,1,0,0,1,1.0
2018-04-19,Louisiana,0,0,1,1,0.5
2018-04-19,Alaska,1,0,0,1,1.0
2018-04-19,Florida,1,0,0,1,1.0
2018-04-18,Arkansas,2,1,1,4,0.625
2018-04-18,California,0,0,2,2,0.5
2018-04-18,Iowa,1,0,0,1,1.0
2018-04-18,Michigan,1,0,0,1,1.0
2018-04-18,Delaware,2,0,0,2,1.0
2018-04-18,Louisiana,2,0,0,2,1.0
2018-04-18,Hawaii,2,0,0,2,1.0
2018-04-18,Indiana,1,0,0,1,1.0
2018-04-18,Alabama,1,0,0,1,1.0
2018-04-18,Florida,1,0,0,1,1.0
2018-04-18,North Carolina,1,0,0,1,1.0
2018-04-18,Arizona,1,0,0,1,1.0
2018-04-17,Alabama,1,0,1,2,0.75
2018-04-17,Colorado,4,2,1,7,0.6428571428571428
2018-04-17,Hawaii,3,1,1,5,0.7
2018-04-17,California,1,0,1,2,0.75
2018-04-17,Florida,1,0,0,1,1.0
2018-04-17,Massachusetts,2,0,0,2,1.0
2018-04-17,Arkansas,1,0,0,1,1.0
2018-04-17,Texas,1,0,0,1,1.0
2018-04-17,Missouri,1,0,0,1,1.0
2018-04-17,Delaware,1,0,0,1,1.0
2018-04-17,Washington,1,0,0,1,1.0
2018-04-17,Indiana,1,0,0,1,1.0
2018-04-17,Maryland,0,1,0,1,0.0
2018-04-16,Arizona,0,0,2,2,0.5
2018-04-16,Indiana,1,0,0,1,1.0
2018-04-16,California,3,0,1,4,0.875
2018-04-16,Washington,1,0,0,1,1.0
2018-04-16,Illinois,1,0,1,2,0.75
2018-04-16,Massachusetts,0,0,1,1,0.5
2018-04-16,Alabama,1,0,0,1,1.0
2018-04-16,Connecticut,0,0,1,1,0.5
2018-04-16,Arkansas,0,1,0,1,0.0
2018-04-15,Massachusetts,0,1,2,3,0.3333333333333333
2018-04-15,Arizona,0,0,1,1,0.5
2018-04-15,Florida,1,0,1,2,0.75
2018-04-15,Pennsylvania,0,0,1,1,0.5
2018-04-15,Ohio,1,0,0,1,1.0
2018-04-14,Connecticut,1,1,1,3,0.5
2018-04-14,Hawaii,0,1,0,1,0.0
2018-04-14,Indiana,1,0,1,2,0.75
2018-04-14,California,0,1,0,1,0.0
2018-04-14,Georgia,0,0,1,1,0.5
2018-04-14,Delaware,0,0,1,1,0.5
2018-04-14,Massachusetts,1,0,0,1,1.0
2018-04-14,Ohio,1,0,0,1,1.0
2018-04-14,Alabama,0,1,0,1,0.0
2018-04-14,Idaho,1,0,0,1,1.0
2018-04-14,Louisiana,1,0,0,1,1.0
2018-04-13,Connecticut,1,0,0,1,1.0
2018-04-13,South Carolina,0,1,0,1,0.0
2018-04-13,California,2,1,1,4,0.625
2018-04-13,Massachusetts,0,2,1,3,0.16666666666666666
2018-04-13,Florida,1,0,0,1,1.0
2018-04-13,Colorado,1,0,0,1,1.0
2018-04-13,Arkansas,1,0,2,3,0.6666666666666666
2018-04-12,Florida,1,0,0,1,1.0
2018-04-12,New Jersey,1,0,0,1,1.0
2018-04-12,Arkansas,0,0,1,1,0.5
2018-04-12,California,4,1,1,6,0.75
2018-04-12,New York,2,0,0,2,1.0
2018-04-12,Louisiana,1,0,1,2,0.75
2018-04-12,Texas,1,0,0,1,1.0
2018-04-12,Illinois,0,1,0,1,0.0
2018-04-12,Georgia,1,0,0,1,1.0
2018-04-12,Indiana,0,1,0,1,0.0
2018-04-12,Alabama,1,0,0,1,1.0
2018-04-12,Colorado,1,0,0,1,1.0
2018-04-11,Texas,1,0,0,1,1.0
2018-04-11,Illinois,0,0,1,1,0.5
2018-04-11,Washington,2,0,1,3,0.8333333333333333
2018-04-11,California,1,0,0,1,1.0
2018-04-11,Arkansas,0,0,1,1,0.5
2018-04-11,Colorado,0,1,0,1,0.0
2018-04-11,Minnesota,1,0,0,1,1.0
2018-04-11,Massachusetts,1,0,0,1,1.0
2018-04-11,Florida,1,0,0,1,1.0
2018-04-11,Arizona,1,0,0,1,1.0
2018-04-11,Georgia,0,0,1,1,0.5
2018-04-10,California,5,1,0,6,0.8333333333333334
2018-04-10,Arkansas,0,0,1,1,0.5
2018-04-10,Indiana,0,1,0,1,0.0
2018-04-10,Illinois,1,0,0,1,1.0
2018-04-10,Louisiana,0,0,1,1,0.5
2018-04-09,California,5,0,1,6,0.9166666666666667
2018-04-09,South Carolina,1,0,0,1,1.0
2018-04-09,Massachusetts,0,0,1,1,0.5
2018-04-09,Arkansas,1,0,2,3,0.6666666666666666
2018-04-09,Missouri,1,0,0,1,1.0
2018-04-09,Indiana,1,0,1,2,0.75
2018-04-09,Florida,0,0,1,1,0.5
2018-04-09,Illinois,1,1,0,2,0.5
2018-04-09,Arizona,1,0,0,1,1.0
2018-04-09,Hawaii,1,0,0,1,1.0
2018-04-08,Washington,1,0,0,1,1.0
2018-04-08,California,1,1,0,2,0.5
2018-04-08,New York,2,0,0,2,1.0
2018-04-08,Arkansas,1,1,0,2,0.5
2018-04-08,Arizona,1,0,0,1,1.0
2018-04-08,Louisiana,0,0,1,1,0.5
2018-04-08,Rhode Island,1,0,0,1,1.0
2018-04-08,Alabama,0,1,0,1,0.0
2018-04-07,Massachusetts,1,1,0,2,0.5
2018-04-07,Washington,1,0,0,1,1.0
2018-04-07,Texas,0,2,0,2,0.0
2018-04-07,Indiana,0,1,1,2,0.25
2018-04-07,Arizona,2,0,0,2,1.0
2018-04-07,Arkansas,1,0,0,1,1.0
2018-04-07,Colorado,1,0,0,1,1.0
2018-04-06,Alabama,1,1,1,3,0.5
2018-04-06,Delaware,1,0,0,1,1.0
2018-04-06,Texas,1,0,0,1,1.0
2018-04-06,Louisiana,1,0,0,1,1.0
2018-04-06,California,0,3,0,3,0.0
2018-04-06,New York,1,0,0,1,1.0
2018-04-06,Indiana,1,1,0,2,0.5
2018-04-05,Washington,3,0,0,3,1.0
2018-04-05,Arizona,1,0,0,1,1.0
2018-04-05,Arkansas,2,0,1,3,0.8333333333333333
2018-04-05,California,1,2,2,5,0.4
2018-04-05,Illinois,1,0,0,1,1.0
2018-04-05,Louisiana,2,0,0,2,1.0
2018-04-05,New York,0,0,2,2,0.5
2018-04-05,Florida,1,0,0,1,1.0
2018-04-05,Hawaii,1,0,0,1,1.0
2018-04-04,Kentucky,1,0,0,1,1.0
2018-04-04,Alabama,2,0,0,2,1.0
2018-04-04,California,1,1,0,2,0.5
2018-04-04,Pennsylvania,1,0,0,1,1.0
2018-04-04,New Jersey,3,0,0,3,1.0
2018-04-04,Massachusetts,1,2,0,3,0.3333333333333333
2018-04-04,Washington,2,0,0,2,1.0
2018-04-04,Arizona,1,1,0,2,0.5
2018-04-04,Colorado,0,1,0,1,0.0
2018-04-04,Illinois,1,0,0,1,1.0
2018-04-04,Hawaii,1,0,1,2,0.75
2018-04-04,Delaware,1,0,0,1,1.0
2018-04-03,Illinois,2,0,0,2,1.0
2018-04-03,Iowa,1,0,1,2,0.75
2018-04-03,California,2,0,1,3,0.8333333333333333
2018-04-03,Hawaii,1,0,0,1,1.0
2018-04-03,Alabama,1,0,0,1,1.0
2018-04-03,Nebraska,0,0,1,1,0.5
2018-04-03,Massachusetts,2,0,0,2,1.0
2018-04-03,Connecticut,0,1,0,1,0.0
2018-04-03,Missouri,1,0,0,1,1.0
2018-04-03,Delaware,1,0,0,1,1.0
2018-04-02,Alabama,1,0,2,3,0.6666666666666666
2018-04-02,Florida,3,0,0,3,1.0
2018-04-02,Massachusetts,1,2,0,3,0.3333333333333333
2018-04-02,Arizona,1,1,0,2,0.5
2018-04-02,California,0,1,1,2,0.25
2018-04-02,Arkansas,1,1,0,2,0.5
2018-04-02,Delaware,1,0,0,1,1.0
2018-04-02,Colorado,0,0,1,1,0.5
2018-04-02,Illinois,1,0,0,1,1.0
2018-04-01,Alabama,2,0,0,2,1.0
2018-04-01,Alaska,1,0,0,1,1.0
2018-04-01,Arkansas,1,0,0,1,1.0
2018-04-01,California,2,1,0,3,0.6666666666666666
2018-03-31,California,0,1,2,3,0.3333333333333333
2018-03-31,Colorado,1,0,0,1,1.0
2018-03-31,Washington,1,0,0,1,1.0
2018-03-31,Arizona,0,1,0,1,0.0
2018-03-31,Florida,0,0,1,1,0.5
2018-03-31,Massachusetts,1,0,0,1,1.0
2018-03-31,Nebraska,1,0,0,1,1.0
2018-03-30,California,1,1,0,2,0.5
2018-03-30,Alabama,1,0,2,3,0.6666666666666666
2018-03-30,Washington,1,0,0,1,1.0
2018-03-30,Illinois,1,0,2,3,0.6666666666666666
2018-03-30,Florida,0,1,0,1,0.0
2018-03-30,New Jersey,1,0,0,1,1.0
2018-03-30,Hawaii,1,0,0,1,1.0
2018-03-30,Colorado,0,1,0,1,0.0
2018-03-29,California,2,0,1,3,0.8333333333333333
2018-03-29,Georgia,1,0,0,1,1.0
2018-03-29,Arkansas,1,0,0,1,1.0
2018-03-29,New York,0,0,1,1,0.5
2018-03-29,Alaska,2,0,0,2,1.0
2018-03-29,Massachusetts,0,1,0,1,0.0
2018-03-29,Hawaii,1,0,0,1,1.0
2018-03-29,Arizona,1,0,0,1,1.0
2018-03-28,Alabama,1,0,0,1,1.0
2018-03-28,Massachusetts,1,0,1,2,0.75
2018-03-28,California,0,0,1,1,0.5
2018-03-28,Colorado,1,0,0,1,1.0
2018-03-28,Louisiana,0,1,0,1,0.0
2018-03-28,Washington,1,0,0,1,1.0
2018-03-27,Illinois,0,0,1,1,0.5
2018-03-27,Alaska,1,0,0,1,1.0
2018-03-27,Arkansas,0,1,1,2,0.25
2018-03-27,Massachusetts,1,1,3,5,0.5
2018-03-27,Missouri,2,0,0,2,1.0
2018-03-27,Indiana,1,0,0,1,1.0
2018-03-27,New York,0,1,1,2,0.25
2018-03-26,Massachusetts,1,0,1,2,0.75
2018-03-26,Michigan,1,0,0,1,1.0
2018-03-26,Missouri,0,0,1,1,0.5
2018-03-26,California,1,0,0,1,1.0
2018-03-26,Alabama,0,1,0,1,0.0
2018-03-26,Georgia,0,1,0,1,0.0
2018-03-25,Arizona,1,0,0,1,1.0
2018-03-25,Iowa,1,0,0,1,1.0
2018-03-25,Maine,0,1,0,1,0.0
2018-03-25,Washington,1,0,0,1,1.0
2018-03-25,New Jersey,1,0,0,1,1.0
2018-03-25,Oregon,1,0,0,1,1.0
2018-03-25,Alabama,0,1,0,1,0.0
2018-03-24,Delaware,1,0,1,2,0.75
2018-03-24,California,1,1,0,2,0.5
2018-03-24,Hawaii,1,0,0,1,1.0
2018-03-24,Alabama,0,1,0,1,0.0
2018-03-24,Arkansas,0,1,0,1,0.0
2018-03-24,Rhode Island,1,0,0,1,1.0
2018-03-24,New York,1,0,0,1,1.0
2018-03-23,Hawaii,0,0,1,1,0.5
2018-03-23,Texas,0,0,1,1,0.5
2018-03-23,Missouri,2,0,0,2,1.0
2018-03-23,Arizona,1,0,0,1,1.0
2018-03-23,Arkansas,0,1,0,1,0.0
2018-03-23,Colorado,0,1,1,2,0.25
2018-03-23,Michigan,0,0,1,1,0.5
2018-03-23,Massachusetts,2,0,0,2,1.0
2018-03-23,California,1,0,0,1,1.0
2018-03-23,Indiana,1,1,1,3,0.5
2018-03-23,New York,1,0,0,1,1.0
2018-03-23,Illinois,1,0,0,1,1.0
2018-03-23,Alabama,1,0,0,1,1.0
2018-03-22,Missouri,0,1,0,1,0.0
2018-03-22,California,2,0,1,3,0.8333333333333333
2018-03-22,Maryland,0,1,0,1,0.0
2018-03-22,Massachusetts,1,0,0,1,1.0
2018-03-22,Indiana,1,0,0,1,1.0
2018-03-22,Hawaii,1,0,1,2,0.75
2018-03-22,Louisiana,1,0,0,1,1.0
2018-03-22,Florida,1,1,0,2,0.5
2018-03-22,New York,0,1,0,1,0.0
2018-03-22,Arizona,1,0,0,1,1.0
2018-03-21,Massachusetts,4,1,0,5,0.8
2018-03-21,Hawaii,1,0,1,2,0.75
2018-03-21,Alabama,0,0,1,1,0.5
2018-03-21,California,1,0,0,1,1.0
2018-03-21,Colorado,1,0,0,1,1.0
2018-03-21,Florida,1,0,0,1,1.0
2018-03-21,Arizona,1,0,0,1,1.0
2018-03-20,Arkansas,1,0,0,1,1.0
2018-03-20,Oregon,1,0,0,1,1.0
2018-03-20,Hawaii,0,0,1,1,0.5
2018-03-20,Washington,1,0,0,1,1.0
2018-03-20,Delaware,0,1,0,1,0.0
2018-03-20,Indiana,1,0,1,2,0.75
2018-03-20,California,2,0,1,3,0.8333333333333333
2018-03-20,Alabama,2,0,0,2,1.0
2018-03-20,Massachusetts,0,0,1,1,0.5
2018-03-20,Texas,1,0,0,1,1.0
2018-03-20,Minnesota,0,0,1,1,0.5
2018-03-19,New York,2,0,0,2,1.0
2018-03-19,California,2,1,0,3,0.6666666666666666
2018-03-19,Louisiana,1,0,0,1,1.0
2018-03-19,Hawaii,1,0,0,1,1.0
2018-03-19,Illinois,0,1,0,1,0.0
2018-03-19,Washington,1,0,0,1,1.0
2018-03-19,Alabama,1,0,0,1,1.0
2018-03-19,Massachusetts,2,0,1,3,0.8333333333333333
2018-03-19,Colorado,0,0,1,1,0.5
2018-03-18,New York,0,0,1,1,0.5
2018-03-18,Arizona,0,0,1,1,0.5
2018-03-18,Alabama,1,1,0,2,0.5
2018-03-18,Delaware,0,0,1,1,0.5
2018-03-18,California,1,0,0,1,1.0
2018-03-17,Missouri,1,1,1,3,0.5
2018-03-17,Arkansas,1,0,0,1,1.0
2018-03-17,Hawaii,1,0,0,1,1.0
2018-03-17,Indiana,1,0,0,1,1.0
2018-03-17,California,1,0,1,2,0.75
2018-03-17,Washington,1,0,0,1,1.0
2018-03-17,Illinois,1,0,0,1,1.0
2018-03-16,California,1,1,2,4,0.5
2018-03-16,Texas,1,0,0,1,1.0
2018-03-16,Georgia,0,0,1,1,0.5
2018-03-16,Florida,1,0,0,1,1.0
2018-03-16,Massachusetts,0,0,1,1,0.5
2018-03-16,Washington,1,0,2,3,0.6666666666666666
2018-03-15,California,0,0,1,1,0.5
2018-03-15,Alaska,1,0,0,1,1.0
2018-03-15,Delaware,0,1,0,1,0.0
2018-03-15,Alabama,0,0,2,2,0.5
2018-03-15,Arkansas,0,0,1,1,0.5
2018-03-15,Indiana,2,0,0,2,1.0
2018-03-15,Illinois,0,0,1,1,0.5
2018-03-15,Nebraska,1,0,0,1,1.0
2018-03-15,Georgia,1,0,0,1,1.0
2018-03-14,Georgia,2,0,0,2,1.0
2018-03-14,Nebraska,0,0,1,1,0.5
2018-03-14,Massachusetts,1,0,1,2,0.75
2018-03-14,California,1,0,1,2,0.75
2018-03-14,Arkansas,1,0,0,1,1.0
2018-03-14,North Carolina,0,0,1,1,0.5
2018-03-14,Indiana,0,1,0,1,0.0
2018-03-14,New York,0,0,1,1,0.5
2018-03-13,New York,1,0,1,2,0.75
2018-03-13,Indiana,0,0,1,1,0.5
2018-03-13,Washington,1,0,0,1,1.0
2018-03-13,Arkansas,0,0,3,3,0.5
2018-03-13,Alabama,0,1,0,1,0.0
2018-03-13,Minnesota,1,0,0,1,1.0
2018-03-13,Massachusetts,1,1,1,3,0.5
2018-03-13,Louisiana,0,0,1,1,0.5
2018-03-13,Connecticut,0,0,1,1,0.5
2018-03-13,Nebraska,1,0,0,1,1.0
2018-03-13,Colorado,0,0,1,1,0.5
2018-03-12,Massachusetts,1,0,0,1,1.0
2018-03-12,Hawaii,1,1,0,2,0.5
2018-03-12,Florida,1,0,0,1,1.0
2018-03-12,Colorado,1,0,0,1,1.0
2018-03-12,Arkansas,0,1,0,1,0.0
2018-03-12,Indiana,1,0,0,1,1.0
2018-03-12,Illinois,1,0,0,1,1.0
2018-03-12,Arizona,1,0,0,1,1.0
2018-03-11,Massachusetts,0,1,0,1,0.0
2018-03-11,Alabama,1,0,0,1,1.0
2018-03-11,Louisiana,1,0,0,1,1.0
2018-03-11,California,1,0,0,1,1.0
2018-03-11,Missouri,1,0,1,2,0.75
2018-03-10,Missouri,1,0,1,2,0.75
2018-03-10,California,1,0,0,1,1.0
2018-03-10,Alaska,0,1,0,1,0.0
2018-03-10,Iowa,1,0,0,1,1.0
2018-03-10,New York,0,0,1,1,0.5
2018-03-10,Massachusetts,0,0,1,1,0.5
2018-03-10,Colorado,1,0,0,1,1.0
2018-03-09,Arkansas,0,0,1,1,0.5
2018-03-09,California,0,0,1,1,0.5
2018-03-09,Alabama,1,0,0,1,1.0
2018-03-09,Louisiana,1,0,0,1,1.0
2018-03-09,Washington,1,0,0,1,1.0
2018-03-09,Virginia,0,1,0,1,0.0
2018-03-08,Louisiana,0,1,0,1,0.0
2018-03-08,California,2,1,0,3,0.6666666666666666
2018-03-08,Indiana,1,0,0,1,1.0
2018-03-08,Arkansas,1,1,0,2,0.5
2018-03-08,Massachusetts,0,0,1,1,0.5
2018-03-08,Alabama,1,0,1,2,0.75
2018-03-08,Maryland,0,0,1,1,0.5
2018-03-08,Washington,1,0,0,1,1.0
2018-03-07,Indiana,1,0,0,1,1.0
2018-03-07,Massachusetts,1,0,0,1,1.0
2018-03-07,California,3,1,0,4,0.75
2018-03-07,Georgia,1,0,0,1,1.0
2018-03-07,Arizona,2,0,0,2,1.0
2018-03-07,New York,0,0,1,1,0.5
2018-03-07,Delaware,3,0,0,3,1.0
2018-03-07,Alaska,1,0,0,1,1.0
2018-03-07,Alabama,0,1,0,1,0.0
2018-03-07,Illinois,1,0,1,2,0.75
2018-03-07,Louisiana,0,0,1,1,0.5
2018-03-07,Hawaii,1,0,0,1,1.0
2018-03-06,Alabama,0,1,1,2,0.25
2018-03-06,Massachusetts,1,0,0,1,1.0
2018-03-06,Missouri,0,1,0,1,0.0
2018-03-06,Idaho,1,0,0,1,1.0
2018-03-06,Georgia,0,0,1,1,0.5
2018-03-06,Indiana,1,0,0,1,1.0
2018-03-06,Louisiana,2,0,1,3,0.8333333333333333
2018-03-06,Arizona,1,0,0,1,1.0
2018-03-06,Hawaii,1,0,0,1,1.0
2018-03-05,Illinois,1,1,0,2,0.5
2018-03-05,Iowa,1,0,0,1,1.0
2018-03-05,Massachusetts,3,1,0,4,0.75
2018-03-05,Indiana,1,0,0,1,1.0
2018-03-05,California,1,1,0,2,0.5
2018-03-05,Texas,2,0,0,2,1.0
2018-03-05,Arizona,2,0,0,2,1.0
2018-03-05,Arkansas,0,1,1,2,0.25
2018-03-05,Hawaii,0,0,1,1,0.5
2018-03-05,Alabama,1,0,0,1,1.0
2018-03-04,New York,0,0,1,1,0.5
2018-03-04,Hawaii,1,0,0,1,1.0
2018-03-03,California,1,0,0,1,1.0
2018-03-03,Colorado,1,0,1,2,0.75
2018-03-03,Massachusetts,1,0,2,3,0.6666666666666666
2018-03-03,Hawaii,2,0,1,3,0.8333333333333333
2018-03-03,Louisiana,1,0,0,1,1.0
2018-03-03,Washington,0,0,1,1,0.5
2018-03-03,Delaware,1,0,0,1,1.0
2018-03-03,Arizona,1,0,0,1,1.0
2018-03-02,California,1,0,0,1,1.0
2018-02-25,Alabama,1,0,0,1,1.0
2018-02-21,Illinois,0,0,1,1,0.5
2018-02-21,Arizona,1,0,0,1,1.0
2018-02-20,Illinois,1,0,0,1,1.0
2018-02-17,Hawaii,0,1,0,1,0.0
2018-02-13,California,1,0,0,1,1.0
2018-02-12,Massachusetts,1,2,0,3,0.3333333333333333
2018-02-10,Hawaii,1,0,0,1,1.0
2018-02-06,California,1,0,0,1,1.0
2018-02-05,Georgia,1,0,0,1,1.0
2018-02-04,Arizona,1,0,0,1,1.0
2018-02-01,Georgia,0,0,2,2,0.5
2018-01-31,Massachusetts,1,0,0,1,1.0
2018-01-31,Missouri,0,1,0,1,0.0
2018-01-30,Illinois,1,0,0,1,1.0
2018-01-29,Hawaii,0,0,1,1,0.5
2018-01-28,Louisiana,0,0,1,1,0.5
2018-01-27,Alabama,1,0,0,1,1.0
2018-01-27,Hawaii,1,0,0,1,1.0
2018-01-26,California,0,1,0,1,0.0
2018-01-25,Pennsylvania,0,0,1,1,0.5
2018-01-25,Hawaii,1,0,0,1,1.0
2018-01-20,Alabama,1,0,0,1,1.0
2018-01-17,Indiana,0,0,1,1,0.5
2018-01-14,Massachusetts,0,1,0,1,0.0
2018-01-11,Arkansas,1,0,0,1,1.0
2018-01-10,California,1,0,0,1,1.0
2018-01-10,Michigan,0,1,0,1,0.0
2018-01-10,Indiana,0,0,1,1,0.5
2018-01-09,Hawaii,1,0,0,1,1.0
2018-01-08,California,1,0,0,1,1.0
2018-01-08,Indiana,1,0,0,1,1.0
2018-01-08,Alabama,1,0,0,1,1.0
2018-01-06,Texas,0,1,0,1,0.0
2018-01-05,California,0,1,0,1,0.0
2018-01-03,Arizona,0,1,0,1,0.0
2018-01-01,Arizona,0,0,1,1,0.5
2017-12-31,Hawaii,1,0,0,1,1.0
2017-12-31,Delaware,0,1,0,1,0.0
2017-12-30,Kentucky,0,1,0,1,0.0
2017-12-29,Delaware,1,0,0,1,1.0
2017-12-23,Arkansas,0,1,0,1,0.0
2017-12-22,Texas,1,0,0,1,1.0
2017-12-17,Arkansas,1,0,0,1,1.0
2017-12-14,Arkansas,1,0,0,1,1.0
2017-12-12,Nebraska,0,0,1,1,0.5
2017-12-11,California,1,0,0,1,1.0
2017-12-11,Illinois,1,0,0,1,1.0
2017-12-09,Arizona,2,0,0,2,1.0
2017-12-08,Colorado,0,1,0,1,0.0
2017-12-05,Arizona,1,0,0,1,1.0
2017-12-04,Louisiana,1,0,0,1,1.0
2017-11-29,Alabama,4,0,2,6,0.8333333333333333
2017-11-28,Georgia,0,1,0,1,0.0
2017-11-27,Alaska,0,1,0,1,0.0
2017-11-19,Washington,0,1,0,1,0.0
2017-11-17,Hawaii,1,0,0,1,1.0
2017-11-17,New York,0,1,0,1,0.0
2017-11-16,Alabama,1,0,0,1,1.0
2017-11-15,Arizona,3,0,0,3,1.0
2017-11-15,Connecticut,0,0,1,1,0.5
2017-11-15,Maryland,1,1,0,2,0.5
2017-11-14,Arkansas,0,1,0,1,0.0
2017-11-14,Delaware,1,0,0,1,1.0
2017-11-14,Alabama,1,0,0,1,1.0
2017-11-13,Massachusetts,1,0,0,1,1.0
2017-11-12,Maryland,1,0,0,1,1.0
2017-11-12,Arkansas,1,0,0,1,1.0
2017-11-11,Maryland,1,0,1,2,0.75
2017-11-09,Arkansas,1,0,0,1,1.0
2017-11-08,Colorado,3,0,2,5,0.8
2017-11-08,Georgia,9,2,5,16,0.71875
2017-11-08,Hawaii,1,0,0,1,1.0
2017-11-07,Colorado,0,2,0,2,0.0
2017-11-07,Delaware,0,0,1,1,0.5
2017-11-07,Georgia,3,1,1,5,0.7
2017-11-07,Florida,1,0,0,1,1.0
2017-11-06,Georgia,7,6,8,21,0.5238095238095237
2017-11-06,Colorado,4,0,0,4,1.0
2017-11-06,Illinois,0,0,1,1,0.5
2017-11-05,Colorado,2,0,0,2,1.0
2017-11-05,Georgia,3,1,3,7,0.6428571428571428
2017-11-05,Michigan,0,1,0,1,0.0
2017-11-04,Colorado,1,0,0,1,1.0
2017-11-04,Arkansas,0,1,0,1,0.0
2017-11-04,Alabama,0,0,1,1,0.5
2017-11-03,Arkansas,2,0,0,2,1.0
2017-11-03,Alaska,1,0,0,1,1.0
2017-10-30,Alabama,1,0,0,1,1.0
2017-10-29,Alabama,0,0,1,1,0.5
2017-10-24,California,0,1,0,1,0.0
2017-10-23,Massachusetts,0,0,1,1,0.5
2017-10-23,Florida,1,0,0,1,1.0
2017-10-20,Massachusetts,1,0,0,1,1.0
2017-10-17,Arkansas,1,0,0,1,1.0
2017-10-15,Alabama,0,0,1,1,0.5
2017-10-03,Arkansas,1,0,0,1,1.0
2017-09-28,Massachusetts,1,0,0,1,1.0
2017-09-27,Washington,0,1,0,1,0.0
2017-09-27,Maryland,0,0,1,1,0.5
2017-09-27,California,1,0,0,1,1.0
2017-09-27,Massachusetts,1,0,0,1,1.0
2017-09-27,Hawaii,1,1,2,4,0.5
2017-09-26,Georgia,0,0,1,1,0.5
2017-09-20,Delaware,0,1,0,1,0.0
2017-09-17,Delaware,0,1,1,2,0.25
2017-09-16,Arkansas,0,0,1,1,0.5
2017-09-16,Massachusetts,1,0,0,1,1.0
2017-09-15,Delaware,1,0,0,1,1.0
2017-09-15,Georgia,0,1,0,1,0.0
2017-09-15,Alabama,1,0,0,1,1.0
2017-09-15,Arkansas,1,0,0,1,1.0
2017-09-14,Alabama,1,0,1,2,0.75
2017-09-14,New York,0,0,1,1,0.5
2017-09-14,Arizona,0,0,1,1,0.5
2017-09-14,Georgia,1,0,0,1,1.0
2017-09-14,Louisiana,1,0,0,1,1.0
2017-09-14,Alaska,1,0,0,1,1.0
2017-09-14,Colorado,1,0,0,1,1.0
2017-09-14,Missouri,1,0,0,1,1.0
2017-09-13,California,9,3,3,15,0.7
2017-09-13,New York,2,0,2,4,0.75
2017-09-13,Missouri,1,0,0,1,1.0
2017-09-13,Georgia,1,0,0,1,1.0
2017-09-13,Hawaii,3,1,0,4,0.75
2017-09-13,Arizona,0,0,1,1,0.5
2017-09-13,Florida,1,0,0,1,1.0
2017-09-13,Alabama,0,1,1,2,0.25
2017-09-13,Massachusetts,5,4,2,11,0.5454545454545454
2017-09-13,Colorado,1,0,0,1,1.0
2017-09-13,Oregon,2,1,0,3,0.6666666666666666
2017-09-13,Indiana,0,0,1,1,0.5
2017-09-13,Nebraska,2,2,1,5,0.5
2017-09-13,Michigan,1,0,1,2,0.75
2017-09-13,Pennsylvania,0,1,0,1,0.0
2017-09-13,Louisiana,0,1,0,1,0.0
2017-09-13,New Jersey,0,0,1,1,0.5
2017-08-31,Idaho,0,0,1,1,0.5
2017-06-11,Michigan,0,0,1,1,0.5
2017-06-10,Massachusetts,1,0,0,1,1.0
2017-06-10,Indiana,1,0,0,1,1.0
2017-05-12,Hawaii,0,0,2,2,0.5
2017-05-08,Hawaii,0,1,0,1,0.0
2017-05-06,Hawaii,0,0,2,2,0.5
2017-05-05,Florida,0,0,1,1,0.5
2017-05-04,Illinois,0,1,0,1,0.0
2017-05-03,Alabama,0,1,0,1,0.0
2017-05-01,Texas,1,0,0,1,1.0
2017-05-01,Hawaii,1,1,0,2,0.5
2017-05-01,Massachusetts,0,0,1,1,0.5
2017-05-01,Indiana,1,0,0,1,1.0
2017-04-30,Hawaii,1,0,1,2,0.75
2017-04-30,Massachusetts,0,1,0,1,0.0
2017-04-30,Florida,0,0,1,1,0.5
2017-04-30,Alabama,0,1,0,1,0.0
2017-04-30,Arkansas,0,1,0,1,0.0
2017-04-30,Nebraska,1,0,0,1,1.0
2017-04-29,Hawaii,49,37,23,109,0.555045871559633
2017-04-29,California,5,8,2,15,0.39999999999999997
2017-04-29,Maine,1,0,0,1,1.0
2017-04-29,New York,5,0,1,6,0.9166666666666667
2017-04-29,Arizona,2,0,0,2,1.0
2017-04-29,Nebraska,2,2,3,7,0.5
2017-04-29,Washington,1,0,0,1,1.0
2017-04-29,Alabama,1,13,5,19,0.18421052631578946
2017-04-29,Arkansas,3,1,4,8,0.625
2017-04-29,Louisiana,1,1,1,3,0.5
2017-04-29,Alaska,1,1,3,5,0.5
2017-04-29,Idaho,0,1,1,2,0.25
2017-04-29,Georgia,0,1,1,2,0.25
2017-04-29,Texas,1,1,0,2,0.5
2017-04-29,Colorado,1,1,0,2,0.5
2017-04-29,Massachusetts,6,3,1,10,0.65
2017-04-29,Indiana,1,0,0,1,1.0
2017-04-29,Delaware,11,1,5,17,0.7941176470588236
2017-04-29,Illinois,1,0,0,1,1.0
2017-04-29,New Jersey,0,0,1,1,0.5
2017-04-29,Florida,0,0,1,1,0.5
2017-04-28,Hawaii,7,3,2,12,0.6666666666666667
2017-04-28,Alabama,2,0,0,2,1.0
2017-04-28,Delaware,0,1,0,1,0.0
2017-04-28,Indiana,1,1,0,2,0.5
2017-04-28,North Dakota,1,0,0,1,1.0
2017-04-28,New York,1,0,0,1,1.0
2017-04-28,Iowa,1,0,0,1,1.0
2017-04-28,California,1,0,0,1,1.0
2017-04-28,Massachusetts,1,0,0,1,1.0
2017-04-28,Connecticut,1,0,0,1,1.0
2017-04-28,Illinois,1,0,0,1,1.0
2017-04-27,Hawaii,3,0,1,4,0.875
2017-04-27,New York,0,1,0,1,0.0
2017-04-26,New York,0,5,0,5,0.0
2017-04-26,Alabama,1,0,0,1,1.0
2017-04-26,California,5,0,0,5,1.0
2017-04-25,Illinois,0,1,0,1,0.0
2017-04-25,Hawaii,1,1,0,2,0.5
2017-04-25,Iowa,0,0,1,1,0.5
2017-04-25,California,1,0,0,1,1.0
2017-04-25,Alaska,1,0,0,1,1.0
2017-04-24,Colorado,0,0,1,1,0.5
2017-04-24,Florida,1,0,0,1,1.0
2017-04-23,Delaware,1,0,0,1,1.0
2017-04-23,New York,0,0,1,1,0.5
2017-04-22,Hawaii,2,0,0,2,1.0
2017-04-21,Illinois,0,1,0,1,0.0
2017-04-21,California,0,1,0,1,0.0
2017-04-21,Hawaii,1,0,0,1,1.0
2017-04-20,Alabama,0,1,0,1,0.0
2017-04-19,Hawaii,0,1,0,1,0.0
2017-04-19,Massachusetts,0,0,1,1,0.5
2017-04-18,Arkansas,0,0,2,2,0.5
2017-04-17,Delaware,0,0,1,1,0.5
2017-04-16,California,1,0,0,1,1.0
2017-04-16,Michigan,0,0,1,1,0.5
2017-04-15,Indiana,1,0,0,1,1.0
2017-04-13,Michigan,2,0,0,2,1.0
2017-04-12,Missouri,0,0,1,1,0.5
2017-04-12,Texas,0,0,1,1,0.5
2017-04-12,Maryland,1,0,0,1,1.0
2017-04-12,Hawaii,1,0,0,1,1.0
2017-04-12,California,0,0,1,1,0.5
2017-04-11,Indiana,1,1,0,2,0.5
2017-04-11,California,0,0,1,1,0.5
2017-04-10,Hawaii,1,1,0,2,0.5
2017-04-09,Hawaii,1,0,0,1,1.0
2017-04-08,Missouri,1,0,0,1,1.0
2017-04-07,Hawaii,2,2,0,4,0.5
2017-04-07,Maine,1,0,0,1,1.0
2017-04-06,Delaware,0,0,1,1,0.5
2017-04-04,Delaware,2,0,0,2,1.0
2017-04-03,Idaho,0,0,1,1,0.5
2017-04-03,Missouri,1,0,0,1,1.0
2017-04-02,Hawaii,0,1,0,1,0.0
2017-04-02,Alabama,1,0,0,1,1.0
2017-04-02,Indiana,0,1,0,1,0.0
2017-03-31,Arkansas,0,0,1,1,0.5
2017-03-31,California,1,0,0,1,1.0
2017-03-30,Missouri,0,1,0,1,0.0
2017-03-30,Hawaii,0,0,1,1,0.5
2017-03-30,Georgia,0,1,0,1,0.0
2017-03-29,Massachusetts,1,0,0,1,1.0
2017-03-29,Texas,1,0,0,1,1.0
2017-03-28,Hawaii,0,0,1,1,0.5
2017-03-27,Delaware,0,1,0,1,0.0
2017-03-27,Hawaii,0,2,0,2,0.0
2017-03-23,Hawaii,0,2,0,2,0.0
2017-03-23,Indiana,1,0,0,1,1.0
2017-03-22,Louisiana,1,0,0,1,1.0
2017-03-20,Hawaii,1,2,0,3,0.3333333333333333
2017-03-10,Colorado,1,0,0,1,1.0
2017-03-09,Delaware,0,0,1,1,0.5
2017-03-07,Alabama,0,0,1,1,0.5
2017-03-05,Iowa,1,0,0,1,1.0
2017-03-04,Illinois,1,0,0,1,1.0
2017-03-04,Alabama,1,0,0,1,1.0
2017-03-02,Delaware,0,0,1,1,0.5
2017-03-01,Oklahoma,1,0,0,1,1.0
2017-03-01,Florida,1,0,0,1,1.0
2017-02-22,Arkansas,1,0,0,1,1.0
2017-02-22,Texas,2,0,0,2,1.0
2017-02-21,Washington,1,0,0,1,1.0
2017-02-18,Alaska,1,0,0,1,1.0
2017-02-18,Alabama,1,0,0,1,1.0
2017-02-17,Delaware,2,0,0,2,1.0
2017-02-17,Alabama,1,0,0,1,1.0
2017-02-09,California,1,0,0,1,1.0
2017-02-05,Connecticut,1,0,0,1,1.0
2017-02-05,California,0,0,1,1,0.5
2017-02-05,Hawaii,1,0,0,1,1.0
2017-02-05,Virginia,1,0,0,1,1.0
2017-02-01,Massachusetts,1,0,0,1,1.0
2017-01-30,Indiana,1,0,0,1,1.0
2017-01-30,California,1,0,0,1,1.0
2017-01-29,New York,0,1,0,1,0.0
2017-01-27,Indiana,1,0,0,1,1.0
2017-01-26,Massachusetts,2,0,0,2,1.0
2017-01-26,Kentucky,1,0,0,1,1.0
2017-01-26,Indiana,1,0,0,1,1.0
2017-01-26,California,1,0,0,1,1.0
2017-01-26,Florida,1,0,0,1,1.0
2017-01-26,Connecticut,1,0,0,1,1.0
2017-01-26,Colorado,1,0,0,1,1.0
2017-01-26,Hawaii,1,0,0,1,1.0
2017-01-25,California,2,0,0,2,1.0
2017-01-25,Indiana,2,0,0,2,1.0
2017-01-25,Washington,1,0,0,1,1.0
2017-01-25,Virginia,1,0,0,1,1.0
2017-01-25,Florida,1,0,0,1,1.0
2017-01-25,Missouri,1,0,0,1,1.0
2017-01-25,Iowa,1,0,0,1,1.0
2017-01-25,Arizona,1,0,0,1,1.0
2017-01-25,Pennsylvania,1,0,0,1,1.0
2017-01-25,Alabama,1,0,0,1,1.0
2017-01-03,Massachusetts,0,0,1,1,0.5
2017-01-02,California,1,0,0,1,1.0
2016-11-30,Massachusetts,1,0,0,1,1.0
2016-11-23,Illinois,1,0,0,1,1.0
2016-11-22,Hawaii,1,0,0,1,1.0
2016-11-16,Massachusetts,0,0,1,1,0.5
2016-11-10,California,1,0,0,1,1.0
2016-11-09,Massachusetts,1,0,0,1,1.0
2016-11-09,California,0,0,1,1,0.5
2016-11-07,Indiana,1,0,0,1,1.0
2016-10-24,Alabama,1,0,0,1,1.0
2016-10-21,Arkansas,1,0,0,1,1.0
2016-10-19,Massachusetts,0,0,1,1,0.5
2016-10-19,Hawaii,0,0,2,2,0.5
2016-10-19,New York,1,0,0,1,1.0
2016-10-17,California,1,0,0,1,1.0
2016-10-11,Illinois,0,0,1,1,0.5
2016-10-07,Arkansas,1,0,0,1,1.0
2016-10-05,Minnesota,0,0,1,1,0.5
2016-10-04,Alabama,0,1,0,1,0.0
2016-10-03,Minnesota,1,0,0,1,1.0
2016-09-30,New York,0,0,1,1,0.5
2016-09-24,California,1,1,1,3,0.5
2016-09-21,Indiana,1,0,0,1,1.0
2016-09-10,Nebraska,1,0,0,1,1.0
2016-09-06,Pennsylvania,1,0,0,1,1.0
2016-08-23,California,0,1,0,1,0.0
2016-07-21,Massachusetts,1,0,0,1,1.0
2016-06-30,Massachusetts,1,0,0,1,1.0
2016-06-29,Massachusetts,1,0,0,1,1.0
2016-06-28,Massachusetts,1,0,0,1,1.0
2016-06-24,Massachusetts,0,1,0,1,0.0
2016-06-14,Florida,4,2,0,6,0.6666666666666666
2016-06-14,Massachusetts,0,0,1,1,0.5
2016-06-11,Hawaii,1,0,0,1,1.0
2016-05-17,Alabama,1,0,0,1,1.0
2016-05-15,Hawaii,1,0,0,1,1.0
2016-04-22,Massachusetts,1,0,0,1,1.0
2016-04-22,Hawaii,1,0,0,1,1.0
2016-04-20,Massachusetts,1,0,0,1,1.0
2016-03-31,New York,1,0,0,1,1.0
2016-03-24,Delaware,1,0,0,1,1.0
2016-03-23,Delaware,1,0,0,1,1.0
2016-03-21,Hawaii,0,1,0,1,0.0
2016-03-20,New York,0,0,1,1,0.5
2016-02-18,New York,1,0,0,1,1.0
2016-02-17,Connecticut,1,0,0,1,1.0
2016-02-08,Louisiana,1,0,0,1,1.0
2016-02-08,New Jersey,0,1,0,1,0.0
2016-02-02,Massachusetts,2,0,0,2,1.0
2016-01-12,Hawaii,1,0,0,1,1.0
2015-12-31,Arkansas,1,0,0,1,1.0
2015-12-08,Georgia,1,0,0,1,1.0
2015-12-03,Delaware,0,0,1,1,0.5
2015-11-30,Washington,1,0,0,1,1.0
2015-11-28,North Dakota,0,1,0,1,0.0
2015-11-28,Mississippi,0,0,1,1,0.5
2015-11-28,Hawaii,1,0,1,2,0.75
2015-11-21,California,0,0,1,1,0.5
2015-11-16,Oregon,0,1,0,1,0.0
2015-10-20,Delaware,0,1,0,1,0.0
2015-10-19,Florida,3,1,4,8,0.625
2015-10-16,Washington,0,0,1,1,0.5
2015-10-16,Florida,1,0,0,1,1.0
2015-10-15,California,1,0,1,2,0.75
2015-10-15,New York,1,1,0,2,0.5
2015-10-15,Indiana,0,0,1,1,0.5
2015-10-15,Nebraska,1,0,0,1,1.0
2015-10-14,Hawaii,8,3,5,16,0.65625
2015-10-14,Indiana,5,1,3,9,0.7222222222222222
2015-10-14,Washington,0,0,2,2,0.5
2015-10-14,Arkansas,2,0,2,4,0.75
2015-10-14,Georgia,0,0,1,1,0.5
2015-10-14,Nebraska,2,0,0,2,1.0
2015-10-14,Alabama,2,0,0,2,1.0
2015-10-14,Massachusetts,6,5,2,13,0.5384615384615385
2015-10-14,California,17,5,10,32,0.6875
2015-10-14,Colorado,1,3,2,6,0.3333333333333333
2015-10-14,Florida,5,1,3,9,0.7222222222222222
2015-10-14,Kentucky,1,0,0,1,1.0
2015-10-14,Illinois,1,1,3,5,0.5
2015-10-14,Virginia,1,0,0,1,1.0
2015-10-14,Michigan,1,0,0,1,1.0
2015-10-14,Idaho,1,0,0,1,1.0
2015-10-14,Alaska,0,0,1,1,0.5
2015-10-14,New York,1,0,0,1,1.0
2015-10-14,Louisiana,0,0,1,1,0.5
2015-10-13,California,2,0,1,3,0.8333333333333333
2015-10-13,Alabama,1,0,0,1,1.0
2015-10-13,Massachusetts,1,0,0,1,1.0
2015-10-13,Florida,2,0,0,2,1.0
2015-10-13,Arkansas,2,0,0,2,1.0
2015-10-11,Florida,1,0,0,1,1.0
2015-10-10,Florida,0,0,1,1,0.5
2015-10-09,Indiana,1,0,0,1,1.0
2015-10-09,Alabama,0,0,1,1,0.5
2015-10-08,Missouri,1,0,0,1,1.0
2015-10-08,Nebraska,1,0,0,1,1.0
2015-10-07,Indiana,0,0,1,1,0.5
2015-10-03,California,1,0,0,1,1.0
2015-09-22,Oregon,0,0,1,1,0.5
2015-09-21,Missouri,0,1,0,1,0.0
2015-09-16,Hawaii,0,1,0,1,0.0
2015-09-14,Massachusetts,1,0,0,1,1.0
2015-08-28,Louisiana,1,0,0,1,1.0
2015-08-07,New Jersey,0,0,1,1,0.5
2015-05-20,California,1,0,0,1,1.0
2015-04-27,Alabama,0,0,1,1,0.5
2015-04-27,Indiana,0,0,1,1,0.5
2015-04-18,New Hampshire,0,1,0,1,0.0
2015-04-17,New Hampshire,0,3,0,3,0.0
2015-04-16,Colorado,0,1,0,1,0.0
2015-04-08,Indiana,0,1,0,1,0.0
2015-04-04,Hawaii,4,1,0,5,0.8
2015-04-01,Georgia,1,0,0,1,1.0
2015-04-01,Indiana,2,1,0,3,0.6666666666666666
2015-03-31,Massachusetts,0,1,0,1,0.0
2015-03-28,Nebraska,0,1,0,1,0.0
2015-03-21,Indiana,1,1,0,2,0.5
2015-03-20,Indiana,1,0,0,1,1.0
2015-03-18,Indiana,1,0,2,3,0.6666666666666666
2015-03-17,Indiana,1,0,0,1,1.0
2015-03-16,Alabama,0,0,1,1,0.5
2015-03-16,Indiana,0,1,0,1,0.0
2015-03-14,Indiana,2,2,0,4,0.5
2015-03-14,Arkansas,0,1,0,1,0.0
2015-03-13,Indiana,0,1,1,2,0.25
2015-03-12,Indiana,1,2,2,5,0.4
2015-03-10,Indiana,2,1,0,3,0.6666666666666666
2015-03-09,Indiana,1,0,1,2,0.75
2015-03-08,Indiana,4,3,0,7,0.5714285714285714
2015-03-07,Indiana,1,0,0,1,1.0
2015-03-06,Indiana,1,0,0,1,1.0
2015-03-03,Indiana,1,0,0,1,1.0
2015-03-02,Indiana,1,0,0,1,1.0
2015-03-01,Indiana,3,1,3,7,0.6428571428571428
2015-02-25,Indiana,0,1,0,1,0.0
2015-02-24,Indiana,3,0,2,5,0.8
2015-02-22,Indiana,1,1,0,2,0.5
2015-02-21,Nebraska,0,1,0,1,0.0
2015-02-20,Indiana,5,2,4,11,0.6363636363636364
2015-02-20,Nebraska,1,0,0,1,1.0
2015-02-19,Indiana,9,0,4,13,0.8461538461538461
2015-02-18,Indiana,0,1,0,1,0.0
2015-02-17,Indiana,6,1,1,8,0.8125
2015-02-16,Indiana,1,0,1,2,0.75
2015-02-14,Missouri,0,1,0,1,0.0
2015-02-13,Indiana,3,3,0,6,0.5
2015-02-11,Indiana,1,0,0,1,1.0
2015-02-06,Indiana,1,1,2,4,0.5
2015-02-05,Hawaii,1,0,0,1,1.0
2015-02-03,Indiana,1,0,0,1,1.0
2015-01-27,Indiana,0,1,0,1,0.0
2015-01-21,California,0,1,0,1,0.0
2015-01-21,Massachusetts,0,0,1,1,0.5
2015-01-15,Michigan,1,0,0,1,1.0
2015-01-07,Indiana,1,0,0,1,1.0
2015-01-04,Michigan,0,1,0,1,0.0
2014-12-31,Indiana,0,0,1,1,0.5
2014-12-12,Hawaii,0,0,1,1,0.5
2014-12-10,Indiana,0,0,1,1,0.5
2014-12-08,Florida,1,0,0,1,1.0
2014-12-04,Arkansas,1,0,0,1,1.0
2014-12-02,Colorado,1,0,1,2,0.75
2014-12-01,Indiana,3,0,0,3,1.0
2014-11-27,Illinois,1,0,0,1,1.0
2014-11-24,Indiana,1,1,0,2,0.5
2014-11-24,Illinois,0,1,0,1,0.0
2014-11-24,Arizona,0,0,1,1,0.5
2014-11-20,Indiana,0,0,1,1,0.5
2014-11-17,Indiana,2,0,0,2,1.0
2014-11-16,Arkansas,0,1,0,1,0.0
2014-11-15,Indiana,1,0,0,1,1.0
2014-11-14,Indiana,2,0,0,2,1.0
2014-11-13,Connecticut,0,0,1,1,0.5
2014-11-13,Indiana,1,0,0,1,1.0
2014-11-13,Iowa,0,0,1,1,0.5
2014-11-12,Louisiana,1,0,0,1,1.0
2014-11-12,Illinois,1,0,0,1,1.0
2014-11-12,Connecticut,0,2,0,2,0.0
2014-11-10,Washington,0,0,1,1,0.5
2014-11-08,Indiana,0,0,1,1,0.5
2014-11-03,Indiana,0,0,1,1,0.5
2014-11-03,Louisiana,0,1,0,1,0.0
2014-10-30,Massachusetts,0,1,0,1,0.0
2014-10-28,Indiana,0,1,0,1,0.0
2014-10-27,Oregon,0,1,0,1,0.0
2014-10-26,Nebraska,0,2,1,3,0.16666666666666666
2014-10-24,Nebraska,1,0,0,1,1.0
2014-10-22,Iowa,0,1,0,1,0.0
2014-10-22,Florida,1,0,0,1,1.0
2014-10-20,Arkansas,1,0,0,1,1.0
2014-10-20,Iowa,0,1,0,1,0.0
2014-10-20,Pennsylvania,0,1,0,1,0.0
2014-10-18,California,0,1,0,1,0.0
2014-10-17,Arkansas,0,0,1,1,0.5
2014-10-16,New York,1,0,0,1,1.0
2014-10-15,Indiana,0,0,1,1,0.5
2014-10-15,Nebraska,1,0,0,1,1.0
2014-10-15,New York,1,0,0,1,1.0
2014-10-14,Indiana,2,0,0,2,1.0
2014-10-14,New York,0,3,0,3,0.0
2014-10-14,Louisiana,0,1,0,1,0.0
2014-10-14,California,1,0,0,1,1.0
2014-10-11,Nebraska,1,0,0,1,1.0
2014-10-08,Indiana,1,1,0,2,0.5
2014-10-07,Arkansas,0,2,0,2,0.0
2014-10-07,California,0,1,0,1,0.0
2014-10-06,Missouri,0,0,1,1,0.5
2014-10-04,Arizona,1,0,0,1,1.0
2014-10-04,Louisiana,1,0,0,1,1.0
2014-10-02,Louisiana,1,0,0,1,1.0
2014-10-02,Hawaii,0,0,1,1,0.5
2014-10-01,Louisiana,2,0,1,3,0.8333333333333333
2014-10-01,Missouri,0,0,1,1,0.5
2014-09-30,Arkansas,1,0,0,1,1.0
2014-09-29,Nebraska,1,0,0,1,1.0
2014-09-29,Indiana,1,0,1,2,0.75
2014-09-29,Alabama,0,2,0,2,0.0
2014-09-29,Arkansas,1,0,0,1,1.0
2014-09-28,Nebraska,0,0,1,1,0.5
2014-09-27,New York,0,1,1,2,0.25
2014-09-27,Florida,1,0,0,1,1.0
2014-09-26,Indiana,1,0,0,1,1.0
2014-09-26,Maine,0,1,0,1,0.0
2014-09-26,Connecticut,0,1,0,1,0.0
2014-09-26,Nebraska,1,0,0,1,1.0
2014-09-26,Hawaii,1,0,0,1,1.0
2014-09-26,Pennsylvania,0,0,1,1,0.5
2014-09-26,Delaware,1,0,0,1,1.0
2014-09-26,Colorado,0,0,1,1,0.5
2014-09-26,Massachusetts,0,0,1,1,0.5
2014-09-25,Massachusetts,0,1,1,2,0.25
2014-09-25,Louisiana,0,1,0,1,0.0
2014-09-25,Nebraska,0,0,1,1,0.5
2014-09-25,Texas,0,1,0,1,0.0
2014-09-25,Florida,0,1,0,1,0.0
2014-09-25,Illinois,1,0,0,1,1.0
2014-09-24,Illinois,1,1,1,3,0.5
2014-09-24,Massachusetts,2,3,1,6,0.41666666666666663
2014-09-24,Nebraska,3,1,0,4,0.75
2014-09-24,California,0,0,1,1,0.5
2014-09-24,Georgia,1,0,2,3,0.6666666666666666
2014-09-24,Arkansas,0,0,1,1,0.5
2014-09-24,New York,0,0,1,1,0.5
2014-09-24,Indiana,2,0,0,2,1.0
2014-09-23,Massachusetts,6,3,3,12,0.625
2014-09-23,Indiana,3,0,0,3,1.0
2014-09-23,Alaska,0,1,0,1,0.0
2014-09-23,California,3,0,1,4,0.875
2014-09-23,Georgia,0,0,1,1,0.5
2014-09-23,New York,0,0,2,2,0.5
2014-09-23,Illinois,1,2,2,5,0.4
2014-09-23,Missouri,0,2,0,2,0.0
2014-09-23,Delaware,0,0,2,2,0.5
2014-09-23,Arkansas,0,1,0,1,0.0
2014-09-23,Arizona,0,0,1,1,0.5
2014-09-23,Alabama,0,1,1,2,0.25
2014-09-23,Connecticut,0,0,1,1,0.5
2014-09-23,North Carolina,0,1,0,1,0.0
2014-09-22,Massachusetts,20,19,18,57,0.5087719298245614
2014-09-22,California,1,9,2,12,0.16666666666666666
2014-09-22,New York,1,8,9,18,0.3055555555555556
2014-09-22,New Jersey,1,4,1,6,0.25
2014-09-22,Nebraska,5,5,5,15,0.5
2014-09-22,Missouri,0,1,0,1,0.0
2014-09-22,Indiana,0,1,1,2,0.25
2014-09-22,Hawaii,3,0,1,4,0.875
2014-09-22,Idaho,0,1,0,1,0.0
2014-09-22,Louisiana,1,2,1,4,0.375
2014-09-22,Delaware,0,0,2,2,0.5
2014-09-22,Alaska,1,1,0,2,0.5
2014-09-22,Colorado,0,0,1,1,0.5
2014-09-22,Alabama,0,2,1,3,0.16666666666666666
2014-09-22,Illinois,1,0,0,1,1.0
2014-09-22,Georgia,0,0,1,1,0.5
2014-09-22,Maine,0,0,1,1,0.5
2014-09-22,New Hampshire,0,1,0,1,0.0
2014-09-21,Massachusetts,241,274,255,770,0.47857142857142854
2014-09-21,California,13,8,10,31,0.5806451612903226
2014-09-21,Indiana,14,11,5,30,0.55
2014-09-21,New York,16,36,28,80,0.375
2014-09-21,Arkansas,10,8,7,25,0.54
2014-09-21,Michigan,1,2,1,4,0.375
2014-09-21,Alaska,5,4,4,13,0.5384615384615385
2014-09-21,Connecticut,2,1,1,4,0.625
2014-09-21,North Dakota,0,1,0,1,0.0
2014-09-21,Georgia,0,1,2,3,0.3333333333333333
2014-09-21,New Jersey,2,4,3,9,0.38888888888888884
2014-09-21,Delaware,1,1,4,6,0.5
2014-09-21,Maryland,1,1,0,2,0.5
2014-09-21,Louisiana,1,5,7,13,0.34615384615384615
2014-09-21,Nebraska,14,12,25,51,0.5196078431372549
2014-09-21,Illinois,2,11,6,19,0.2631578947368421
2014-09-21,Alabama,10,5,5,20,0.625
2014-09-21,Hawaii,11,4,5,20,0.675
2014-09-21,Rhode Island,1,0,0,1,1.0
2014-09-21,Iowa,1,4,1,6,0.25
2014-09-21,Missouri,1,1,2,4,0.5
2014-09-21,Pennsylvania,0,1,1,2,0.25
2014-09-21,Montana,0,1,0,1,0.0
2014-09-21,Texas,0,2,0,2,0.0
2014-09-21,Arizona,1,0,0,1,1.0
2014-09-21,Colorado,4,4,7,15,0.5
2014-09-21,Washington,3,2,2,7,0.5714285714285714
2014-09-21,Oregon,0,0,1,1,0.5
2014-09-21,Idaho,1,1,0,2,0.5
2014-09-21,Florida,0,2,3,5,0.3
2014-09-21,Oklahoma,0,0,1,1,0.5
2014-09-21,Kansas,1,0,0,1,1.0
2014-09-21,New Hampshire,0,1,0,1,0.0
2014-09-20,Massachusetts,35,20,35,90,0.5833333333333334
2014-09-20,Alabama,1,2,7,10,0.44999999999999996
2014-09-20,Nebraska,0,4,1,5,0.1
2014-09-20,New York,2,3,8,13,0.46153846153846156
2014-09-20,Missouri,2,0,0,2,1.0
2014-09-20,Delaware,0,0,2,2,0.5
2014-09-20,Indiana,1,3,3,7,0.3571428571428571
2014-09-20,North Carolina,0,0,1,1,0.5
2014-09-20,Connecticut,1,1,0,2,0.5
2014-09-20,Louisiana,2,3,4,9,0.4444444444444444
2014-09-20,California,2,4,3,9,0.38888888888888884
2014-09-20,Michigan,0,0,1,1,0.5
2014-09-20,Hawaii,1,3,2,6,0.3333333333333333
2014-09-20,Washington,1,0,0,1,1.0
2014-09-20,Florida,6,0,4,10,0.8
2014-09-20,Colorado,0,1,0,1,0.0
2014-09-20,Illinois,0,1,0,1,0.0
2014-09-20,New Jersey,0,0,2,2,0.5
2014-09-19,Alabama,0,6,9,15,0.3
2014-09-19,New York,2,3,4,9,0.4444444444444444
2014-09-19,Louisiana,1,0,2,3,0.6666666666666666
2014-09-19,Florida,1,0,1,2,0.75
2014-09-19,Georgia,0,2,0,2,0.0
2014-09-19,Massachusetts,1,3,5,9,0.3888888888888889
2014-09-19,Nebraska,1,2,1,4,0.375
2014-09-19,California,2,1,0,3,0.6666666666666666
2014-09-19,Connecticut,0,2,1,3,0.16666666666666666
2014-09-19,Pennsylvania,1,0,0,1,1.0
2014-09-19,Alaska,1,0,1,2,0.75
2014-09-19,Missouri,0,0,1,1,0.5
2014-09-19,Arkansas,0,0,2,2,0.5
2014-09-19,Indiana,0,0,1,1,0.5
2014-09-19,Illinois,0,1,0,1,0.0
2014-09-18,Louisiana,1,2,0,3,0.3333333333333333
2014-09-18,Nebraska,1,3,2,6,0.3333333333333333
2014-09-18,Massachusetts,6,3,9,18,0.5833333333333333
2014-09-18,New York,1,2,3,6,0.41666666666666663
2014-09-18,Indiana,1,0,1,2,0.75
2014-09-18,California,2,1,0,3,0.6666666666666666
2014-09-18,Illinois,1,0,0,1,1.0
2014-09-18,Idaho,1,1,0,2,0.5
2014-09-18,Hawaii,0,1,2,3,0.3333333333333333
2014-09-18,Florida,0,1,0,1,0.0
2014-09-18,Washington,0,1,1,2,0.25
2014-09-18,Alabama,0,1,0,1,0.0
2014-09-18,Arkansas,1,1,5,7,0.5
2014-09-17,Massachusetts,2,3,2,7,0.42857142857142855
2014-09-17,Illinois,2,0,0,2,1.0
2014-09-17,California,1,2,2,5,0.4
2014-09-17,New York,1,1,3,5,0.5
2014-09-17,Nebraska,1,0,0,1,1.0
2014-09-17,Hawaii,0,1,0,1,0.0
2014-09-17,Florida,0,0,1,1,0.5
2014-09-17,Alabama,2,0,0,2,1.0
2014-09-17,Indiana,0,1,0,1,0.0
2014-09-16,Massachusetts,3,4,5,12,0.45833333333333337
2014-09-16,California,1,1,0,2,0.5
2014-09-16,Colorado,2,1,0,3,0.6666666666666666
2014-09-16,Connecticut,0,0,2,2,0.5
2014-09-16,Delaware,2,0,0,2,1.0
2014-09-16,New York,0,0,1,1,0.5
2014-09-16,Hawaii,2,0,0,2,1.0
2014-09-16,Pennsylvania,0,0,1,1,0.5
2014-09-16,Florida,1,0,0,1,1.0
2014-09-16,Nebraska,2,1,0,3,0.6666666666666666
2014-09-16,Idaho,0,1,0,1,0.0
2014-09-15,Arkansas,2,0,0,2,1.0
2014-09-15,Nebraska,1,0,0,1,1.0
2014-09-15,California,1,1,1,3,0.5
2014-09-15,Massachusetts,0,2,1,3,0.16666666666666666
2014-09-15,Pennsylvania,1,0,0,1,1.0
2014-09-15,New Jersey,0,0,1,1,0.5
2014-09-15,Delaware,0,0,1,1,0.5
2014-09-15,New York,1,0,0,1,1.0
2014-09-14,New York,1,1,1,3,0.5
2014-09-14,Michigan,0,1,0,1,0.0
2014-09-14,Massachusetts,0,0,2,2,0.5
2014-09-14,Arkansas,1,0,0,1,1.0
2014-09-14,Indiana,0,0,1,1,0.5
2014-09-14,Alabama,0,1,0,1,0.0
2014-09-13,Massachusetts,1,0,1,2,0.75
2014-09-13,Indiana,0,1,0,1,0.0
2014-09-13,Nebraska,1,0,0,1,1.0
2014-09-13,California,0,0,1,1,0.5
2014-09-12,New York,1,0,1,2,0.75
2014-09-12,Missouri,1,0,0,1,1.0
2014-09-12,Massachusetts,1,0,0,1,1.0
2014-09-12,Nebraska,1,0,1,2,0.75
2014-09-12,Idaho,1,0,0,1,1.0
2014-09-11,New York,0,0,1,1,0.5
2014-09-11,Nebraska,0,1,0,1,0.0
2014-09-11,Illinois,2,0,0,2,1.0
2014-09-11,Massachusetts,1,0,0,1,1.0
2014-09-10,Massachusetts,1,2,6,9,0.4444444444444444
2014-09-10,New York,0,2,0,2,0.0
2014-09-10,Missouri,1,0,1,2,0.75
2014-09-10,Indiana,1,1,0,2,0.5
2014-09-09,Massachusetts,1,2,0,3,0.3333333333333333
2014-09-09,Nebraska,0,0,1,1,0.5
2014-09-09,Connecticut,0,0,1,1,0.5
2014-09-08,Nebraska,1,0,0,1,1.0
2014-09-08,California,0,3,2,5,0.2
2014-09-07,Massachusetts,2,4,1,7,0.3571428571428571
2014-09-07,Hawaii,0,1,1,2,0.25
2014-09-07,Arkansas,1,0,0,1,1.0
2014-09-07,New York,1,0,0,1,1.0
2014-09-07,Texas,1,0,0,1,1.0
2014-09-07,Nebraska,1,0,0,1,1.0
2014-09-06,California,0,1,0,1,0.0
2014-09-06,New York,2,0,0,2,1.0
2014-09-05,New York,0,0,1,1,0.5
2014-09-05,Massachusetts,1,0,1,2,0.75
2014-09-05,New Jersey,1,0,0,1,1.0
2014-09-05,California,0,0,1,1,0.5
2014-09-04,Illinois,0,0,1,1,0.5
2014-09-04,Florida,1,0,0,1,1.0
2014-09-04,New York,0,1,1,2,0.25
2014-09-04,Massachusetts,0,0,1,1,0.5
2014-09-04,Maine,0,0,1,1,0.5
2014-09-03,Maine,0,0,1,1,0.5
2014-09-03,New York,0,1,1,2,0.25
2014-09-03,Massachusetts,0,1,0,1,0.0
2014-09-03,California,0,1,0,1,0.0
2014-09-02,Massachusetts,0,0,1,1,0.5
2014-09-02,Ohio,0,1,0,1,0.0
2014-09-02,Indiana,1,0,0,1,1.0
2014-09-02,Pennsylvania,0,0,1,1,0.5
2014-09-02,California,0,0,1,1,0.5
2014-09-02,New York,0,1,0,1,0.0
2014-09-01,New York,0,0,1,1,0.5
2014-09-01,Alabama,1,0,0,1,1.0
2014-08-30,New York,0,0,1,1,0.5
2014-08-29,New York,1,1,0,2,0.5
2014-08-29,Massachusetts,0,0,1,1,0.5
2014-08-29,Alabama,0,0,1,1,0.5
2014-08-29,California,1,0,0,1,1.0
2014-08-28,California,0,1,0,1,0.0
2014-08-28,Idaho,0,0,1,1,0.5
2014-08-28,Nebraska,0,1,0,1,0.0
2014-08-28,Illinois,1,0,0,1,1.0
2014-08-28,Connecticut,0,1,0,1,0.0
2014-08-28,Arkansas,0,0,1,1,0.5
2014-08-28,Indiana,0,0,1,1,0.5
2014-08-26,Massachusetts,0,0,1,1,0.5
2014-08-26,Idaho,0,0,1,1,0.5
2014-08-25,Massachusetts,1,0,1,2,0.75
2014-08-25,Hawaii,0,1,0,1,0.0
2014-08-25,Alaska,0,1,0,1,0.0
2014-08-25,California,1,0,0,1,1.0
2014-08-24,Missouri,1,0,0,1,1.0
2014-08-23,Arkansas,0,0,1,1,0.5
2014-08-23,Illinois,0,1,0,1,0.0
2014-08-22,California,0,0,2,2,0.5
2014-08-21,Missouri,0,1,0,1,0.0
2014-08-21,California,1,0,0,1,1.0
2014-08-21,New Jersey,1,0,0,1,1.0
2014-08-21,Massachusetts,0,0,1,1,0.5
2014-08-14,Indiana,0,1,0,1,0.0
2014-08-14,Massachusetts,0,1,0,1,0.0
2014-07-30,Nebraska,0,0,2,2,0.5
2014-07-25,Utah,1,0,0,1,1.0
2014-07-12,Indiana,0,1,0,1,0.0
2014-07-08,Nebraska,0,1,0,1,0.0
2014-07-03,Indiana,2,0,1,3,0.8333333333333333
2014-06-22,Nebraska,0,0,1,1,0.5
2014-06-18,Indiana,0,0,1,1,0.5
2014-06-16,Indiana,1,0,0,1,1.0
2014-06-13,Indiana,0,0,1,1,0.5
2014-06-11,Indiana,0,1,0,1,0.0
2014-06-10,Indiana,3,0,0,3,1.0
2014-06-07,Indiana,1,0,1,2,0.75
2014-06-06,Indiana,1,1,0,2,0.5
2014-06-05,Indiana,2,0,0,2,1.0
2014-06-04,Indiana,1,0,0,1,1.0
2014-06-02,Indiana,0,0,1,1,0.5
2014-05-30,Indiana,1,0,0,1,1.0
2014-05-28,Indiana,1,0,0,1,1.0
2014-05-26,Indiana,1,0,0,1,1.0
2014-05-23,Indiana,3,0,1,4,0.875
2014-05-21,Indiana,3,1,0,4,0.75
2014-05-21,Nebraska,0,1,0,1,0.0
2014-05-20,Indiana,2,1,1,4,0.625
2014-05-20,California,0,1,0,1,0.0
2014-05-19,Indiana,0,0,1,1,0.5
2014-05-18,Louisiana,0,1,0,1,0.0
2014-05-18,Indiana,0,0,1,1,0.5
2014-05-17,Indiana,1,0,1,2,0.75
2014-05-16,Indiana,1,0,0,1,1.0
2014-05-15,Texas,1,0,0,1,1.0
2014-05-14,Missouri,0,1,0,1,0.0
2014-05-14,Texas,0,1,0,1,0.0
2014-05-13,Missouri,0,1,0,1,0.0
2014-05-11,Arizona,0,1,0,1,0.0
2014-04-18,Indiana,1,0,0,1,1.0
2014-04-05,Indiana,0,0,1,1,0.5
2014-03-19,Indiana,1,0,0,1,1.0
2014-02-07,Indiana,1,0,0,1,1.0
2014-02-07,Illinois,0,0,1,1,0.5
2014-02-05,California,1,0,0,1,1.0
2014-01-07,Delaware,0,1,0,1,0.0
2013-12-22,Alabama,1,1,0,2,0.5
2013-12-22,Indiana,0,2,0,2,0.0
2013-12-10,Indiana,0,1,0,1,0.0
2013-11-17,Indiana,2,0,1,3,0.8333333333333333
2013-11-05,Indiana,1,0,0,1,1.0
2013-11-04,Indiana,2,0,0,2,1.0
2013-10-29,Indiana,1,0,0,1,1.0
2013-06-02,Nebraska,0,0,1,1,0.5
2013-01-30,Alabama,0,0,1,1,0.5
2013-01-18,Colorado,0,1,0,1,0.0
2013-01-14,Massachusetts,0,0,1,1,0.5
2012-12-03,Hawaii,0,0,1,1,0.5
2012-11-22,Missouri,1,0,0,1,1.0
2012-11-14,Massachusetts,0,1,0,1,0.0
2012-11-14,Hawaii,1,0,0,1,1.0
2012-11-07,Hawaii,1,0,0,1,1.0
2012-11-07,Georgia,0,0,1,1,0.5
2012-11-07,Arkansas,0,0,1,1,0.5
2012-11-06,Arkansas,0,0,1,1,0.5
2012-11-06,Massachusetts,0,1,0,1,0.0
2012-11-02,Massachusetts,0,0,1,1,0.5
2012-11-02,Nebraska,0,1,0,1,0.0
2012-11-02,Maine,0,0,1,1,0.5
2012-11-01,Nebraska,0,0,1,1,0.5
2012-10-30,Massachusetts,1,0,0,1,1.0
2012-10-30,Illinois,0,1,0,1,0.0
2012-10-30,Alabama,0,1,0,1,0.0
2012-10-29,Massachusetts,0,1,0,1,0.0
2012-10-29,California,1,0,0,1,1.0
2012-10-28,Nebraska,1,0,0,1,1.0
2012-10-28,New York,0,0,1,1,0.5
2012-10-28,California,1,0,0,1,1.0
2012-10-27,California,0,0,1,1,0.5
2012-10-25,Missouri,0,1,0,1,0.0
2012-10-24,Missouri,1,0,0,1,1.0
2012-10-22,Massachusetts,0,1,0,1,0.0
2012-10-22,Nebraska,0,0,1,1,0.5
2012-10-22,Alabama,1,0,1,2,0.75
2012-10-22,Hawaii,0,1,1,2,0.25
2012-10-22,Indiana,1,0,0,1,1.0
2012-10-22,Texas,0,0,1,1,0.5
2012-10-22,Missouri,0,1,0,1,0.0
2012-10-20,Texas,0,0,1,1,0.5
2012-10-17,Alabama,1,0,0,1,1.0
2012-10-16,Alabama,0,0,1,1,0.5
2012-10-16,Massachusetts,0,1,0,1,0.0
2012-10-05,Arkansas,0,0,1,1,0.5
2012-10-04,Idaho,1,0,0,1,1.0
2012-09-27,Colorado,0,0,1,1,0.5
2012-07-25,Washington,0,0,1,1,0.5
2012-07-22,California,1,0,0,1,1.0
